libsensorPy	libsensorPy-module.php
libsensorPy.__package__	libsensorPy-module.php#__package__
libsensorPy.abstractclass	libsensorPy.abstractclass-module.php
libsensorPy.abstractclass.__package__	libsensorPy.abstractclass-module.php#__package__
libsensorPy.abstractclass.abstractActuatorFactory	libsensorPy.abstractclass.abstractActuatorFactory-module.php
libsensorPy.abstractclass.abstractActuatorFactory.__package__	libsensorPy.abstractclass.abstractActuatorFactory-module.php#__package__
libsensorPy.abstractclass.abstractEvent	libsensorPy.abstractclass.abstractEvent-module.php
libsensorPy.abstractclass.abstractEvent.__package__	libsensorPy.abstractclass.abstractEvent-module.php#__package__
libsensorPy.abstractclass.abstractSensorFactory	libsensorPy.abstractclass.abstractSensorFactory-module.php
libsensorPy.abstractclass.abstractSensorFactory.__package__	libsensorPy.abstractclass.abstractSensorFactory-module.php#__package__
libsensorPy.abstractclass.accelerometerSensor	libsensorPy.abstractclass.accelerometerSensor-module.php
libsensorPy.abstractclass.actuator	libsensorPy.abstractclass.actuator-module.php
libsensorPy.abstractclass.altitudeSensor	libsensorPy.abstractclass.altitudeSensor-module.php
libsensorPy.abstractclass.dcMotorActuator	libsensorPy.abstractclass.dcMotorActuator-module.php
libsensorPy.abstractclass.eventObserver	libsensorPy.abstractclass.eventObserver-module.php
libsensorPy.abstractclass.eventObserver.__package__	libsensorPy.abstractclass.eventObserver-module.php#__package__
libsensorPy.abstractclass.humiditySensor	libsensorPy.abstractclass.humiditySensor-module.php
libsensorPy.abstractclass.lightSensor	libsensorPy.abstractclass.lightSensor-module.php
libsensorPy.abstractclass.magnetometerSensor	libsensorPy.abstractclass.magnetometerSensor-module.php
libsensorPy.abstractclass.motionSensor	libsensorPy.abstractclass.motionSensor-module.php
libsensorPy.abstractclass.motorActuator	libsensorPy.abstractclass.motorActuator-module.php
libsensorPy.abstractclass.pressureSensor	libsensorPy.abstractclass.pressureSensor-module.php
libsensorPy.abstractclass.sensor	libsensorPy.abstractclass.sensor-module.php
libsensorPy.abstractclass.servoMotorActuator	libsensorPy.abstractclass.servoMotorActuator-module.php
libsensorPy.abstractclass.stepperMotorActuator	libsensorPy.abstractclass.stepperMotorActuator-module.php
libsensorPy.abstractclass.temperatureSensor	libsensorPy.abstractclass.temperatureSensor-module.php
libsensorPy.abstractclass.ultrasonicSensor	libsensorPy.abstractclass.ultrasonicSensor-module.php
libsensorPy.compositesensor	libsensorPy.compositesensor-module.php
libsensorPy.compositesensor.__package__	libsensorPy.compositesensor-module.php#__package__
libsensorPy.compositesensor.bmp085Composite	libsensorPy.compositesensor.bmp085Composite-module.php
libsensorPy.compositesensor.dht11Composite	libsensorPy.compositesensor.dht11Composite-module.php
libsensorPy.compositesensor.dht22Composite	libsensorPy.compositesensor.dht22Composite-module.php
libsensorPy.compositesensor.lsm303dComposite	libsensorPy.compositesensor.lsm303dComposite-module.php
libsensorPy.concreteactuator	libsensorPy.concreteactuator-module.php
libsensorPy.concreteactuator.__package__	libsensorPy.concreteactuator-module.php#__package__
libsensorPy.concreteactuator.stepper28BJY48	libsensorPy.concreteactuator.stepper28BJY48-module.php
libsensorPy.concreteevent	libsensorPy.concreteevent-module.php
libsensorPy.concreteevent.__package__	libsensorPy.concreteevent-module.php#__package__
libsensorPy.concreteevent.temperatureEvent	libsensorPy.concreteevent.temperatureEvent-module.php
libsensorPy.concretefactory	libsensorPy.concretefactory-module.php
libsensorPy.concretefactory.__package__	libsensorPy.concretefactory-module.php#__package__
libsensorPy.concretefactory.accelerometerSensorFactory	libsensorPy.concretefactory.accelerometerSensorFactory-module.php
libsensorPy.concretefactory.altitudeSensorFactory	libsensorPy.concretefactory.altitudeSensorFactory-module.php
libsensorPy.concretefactory.compositeSensorFactory	libsensorPy.concretefactory.compositeSensorFactory-module.php
libsensorPy.concretefactory.humiditySensorFactory	libsensorPy.concretefactory.humiditySensorFactory-module.php
libsensorPy.concretefactory.lightSensorFactory	libsensorPy.concretefactory.lightSensorFactory-module.php
libsensorPy.concretefactory.magnetometerSensorFactory	libsensorPy.concretefactory.magnetometerSensorFactory-module.php
libsensorPy.concretefactory.motionSensorFactory	libsensorPy.concretefactory.motionSensorFactory-module.php
libsensorPy.concretefactory.pressureSensorFactory	libsensorPy.concretefactory.pressureSensorFactory-module.php
libsensorPy.concretefactory.stepperMotorActuatorFactory	libsensorPy.concretefactory.stepperMotorActuatorFactory-module.php
libsensorPy.concretefactory.temperatureSensorFactory	libsensorPy.concretefactory.temperatureSensorFactory-module.php
libsensorPy.concretefactory.ultrasonicSensorFactory	libsensorPy.concretefactory.ultrasonicSensorFactory-module.php
libsensorPy.concreteobserver	libsensorPy.concreteobserver-module.php
libsensorPy.concreteobserver.__package__	libsensorPy.concreteobserver-module.php#__package__
libsensorPy.concreteobserver.currentConditionDisplay	libsensorPy.concreteobserver.currentConditionDisplay-module.php
libsensorPy.concretesensor	libsensorPy.concretesensor-module.php
libsensorPy.concretesensor.__package__	libsensorPy.concretesensor-module.php#__package__
libsensorPy.concretesensor.adxl345	libsensorPy.concretesensor.adxl345-module.php
libsensorPy.concretesensor.bmp085Altitude	libsensorPy.concretesensor.bmp085Altitude-module.php
libsensorPy.concretesensor.bmp085Pressure	libsensorPy.concretesensor.bmp085Pressure-module.php
libsensorPy.concretesensor.bmp085Temperature	libsensorPy.concretesensor.bmp085Temperature-module.php
libsensorPy.concretesensor.dht11Humidity	libsensorPy.concretesensor.dht11Humidity-module.php
libsensorPy.concretesensor.dht11Temperature	libsensorPy.concretesensor.dht11Temperature-module.php
libsensorPy.concretesensor.dht22Humidity	libsensorPy.concretesensor.dht22Humidity-module.php
libsensorPy.concretesensor.dht22Temperature	libsensorPy.concretesensor.dht22Temperature-module.php
libsensorPy.concretesensor.hmc5883l	libsensorPy.concretesensor.hmc5883l-module.php
libsensorPy.concretesensor.hysrf05	libsensorPy.concretesensor.hysrf05-module.php
libsensorPy.concretesensor.lsm303dAccelerometer	libsensorPy.concretesensor.lsm303dAccelerometer-module.php
libsensorPy.concretesensor.lsm303dMagnetometer	libsensorPy.concretesensor.lsm303dMagnetometer-module.php
libsensorPy.concretesensor.parallaxPing	libsensorPy.concretesensor.parallaxPing-module.php
libsensorPy.concretesensor.pir	libsensorPy.concretesensor.pir-module.php
libsensorPy.concretesensor.srf04	libsensorPy.concretesensor.srf04-module.php
libsensorPy.concretesensor.srf05	libsensorPy.concretesensor.srf05-module.php
libsensorPy.concretesensor.tcs34725	libsensorPy.concretesensor.tcs34725-module.php
libsensorPy.concretesensor.urm37	libsensorPy.concretesensor.urm37-module.php
libsensorPy.examples	libsensorPy.examples-module.php
libsensorPy.examples.__package__	libsensorPy.examples-module.php#__package__
libsensorPy.examples.Stepper28BJY48Example	libsensorPy.examples.Stepper28BJY48Example-module.php
libsensorPy.examples.adxl345Example	libsensorPy.examples.adxl345Example-module.php
libsensorPy.examples.bmp085AltitudeExample	libsensorPy.examples.bmp085AltitudeExample-module.php
libsensorPy.examples.bmp085CompositeExample	libsensorPy.examples.bmp085CompositeExample-module.php
libsensorPy.examples.bmp085PressureExample	libsensorPy.examples.bmp085PressureExample-module.php
libsensorPy.examples.bmp085TemperatureExample	libsensorPy.examples.bmp085TemperatureExample-module.php
libsensorPy.examples.dht11CompositeExample	libsensorPy.examples.dht11CompositeExample-module.php
libsensorPy.examples.dht11HumidityExample	libsensorPy.examples.dht11HumidityExample-module.php
libsensorPy.examples.dht11TemperatureExample	libsensorPy.examples.dht11TemperatureExample-module.php
libsensorPy.examples.dht22CompositeExample	libsensorPy.examples.dht22CompositeExample-module.php
libsensorPy.examples.dht22HumidityExample	libsensorPy.examples.dht22HumidityExample-module.php
libsensorPy.examples.dht22TemperatureExample	libsensorPy.examples.dht22TemperatureExample-module.php
libsensorPy.examples.hmc5883lExample	libsensorPy.examples.hmc5883lExample-module.php
libsensorPy.examples.hysrf05Example	libsensorPy.examples.hysrf05Example-module.php
libsensorPy.examples.lsm303dAccelerometerExample	libsensorPy.examples.lsm303dAccelerometerExample-module.php
libsensorPy.examples.lsm303dCompositeExample	libsensorPy.examples.lsm303dCompositeExample-module.php
libsensorPy.examples.lsm303dMagnetometerExample	libsensorPy.examples.lsm303dMagnetometerExample-module.php
libsensorPy.examples.parallaxPingExample	libsensorPy.examples.parallaxPingExample-module.php
libsensorPy.examples.pirExample	libsensorPy.examples.pirExample-module.php
libsensorPy.examples.srf04Example	libsensorPy.examples.srf04Example-module.php
libsensorPy.examples.srf05Example	libsensorPy.examples.srf05Example-module.php
libsensorPy.examples.tcs34725Example	libsensorPy.examples.tcs34725Example-module.php
libsensorPy.examples.urm37Example	libsensorPy.examples.urm37Example-module.php
libsensorPy.extension	libsensorPy.extension-module.php
libsensorPy.extension.__package__	libsensorPy.extension-module.php#__package__
libsensorPy.extension.extendedUltrasonicSensorFactory	libsensorPy.extension.extendedUltrasonicSensorFactory-module.php
libsensorPy.extension.hcsr04	libsensorPy.extension.hcsr04-module.php
libsensorPy.extension.hcsr04ExtensionExample	libsensorPy.extension.hcsr04ExtensionExample-module.php
libsensorPy.setup	libsensorPy.setup-module.php
libsensorPy.setup.read	libsensorPy.setup-module.php#read
libsensorPy.utils	libsensorPy.utils-module.php
libsensorPy.utils.__package__	libsensorPy.utils-module.php#__package__
libsensorPy.utils.pycomms	libsensorPy.utils.pycomms-module.php
abc.ABCMeta	abc.ABCMeta-class.php
abc.ABCMeta.__new__	abc.ABCMeta-class.php#__new__
abc.ABCMeta._abc_invalidation_counter	abc.ABCMeta-class.php#_abc_invalidation_counter
abc.ABCMeta.__instancecheck__	abc.ABCMeta-class.php#__instancecheck__
abc.ABCMeta.__subclasscheck__	abc.ABCMeta-class.php#__subclasscheck__
abc.ABCMeta.register	abc.ABCMeta-class.php#register
abc.ABCMeta._dump_registry	abc.ABCMeta-class.php#_dump_registry
libsensorPy.abstractclass.abstractActuatorFactory.AbstractActuatorFactory	libsensorPy.abstractclass.abstractActuatorFactory.AbstractActuatorFactory-class.php
libsensorPy.abstractclass.abstractActuatorFactory.AbstractActuatorFactory.__metaclass__	abc.ABCMeta-class.php
libsensorPy.abstractclass.abstractActuatorFactory.AbstractActuatorFactory._abc_negative_cache	libsensorPy.abstractclass.abstractActuatorFactory.AbstractActuatorFactory-class.php#_abc_negative_cache
libsensorPy.abstractclass.abstractActuatorFactory.AbstractActuatorFactory.__init__	libsensorPy.abstractclass.abstractActuatorFactory.AbstractActuatorFactory-class.php#__init__
libsensorPy.abstractclass.abstractActuatorFactory.AbstractActuatorFactory._abc_cache	libsensorPy.abstractclass.abstractActuatorFactory.AbstractActuatorFactory-class.php#_abc_cache
libsensorPy.abstractclass.abstractActuatorFactory.AbstractActuatorFactory.__abstractmethods__	libsensorPy.abstractclass.abstractActuatorFactory.AbstractActuatorFactory-class.php#__abstractmethods__
libsensorPy.abstractclass.abstractActuatorFactory.AbstractActuatorFactory.createActuator	libsensorPy.abstractclass.abstractActuatorFactory.AbstractActuatorFactory-class.php#createActuator
libsensorPy.abstractclass.abstractActuatorFactory.AbstractActuatorFactory._abc_negative_cache_version	libsensorPy.abstractclass.abstractActuatorFactory.AbstractActuatorFactory-class.php#_abc_negative_cache_version
libsensorPy.abstractclass.abstractActuatorFactory.AbstractActuatorFactory._abc_registry	libsensorPy.abstractclass.abstractActuatorFactory.AbstractActuatorFactory-class.php#_abc_registry
libsensorPy.abstractclass.abstractActuatorFactory.AbstractActuatorFactory.createEvent	libsensorPy.abstractclass.abstractActuatorFactory.AbstractActuatorFactory-class.php#createEvent
libsensorPy.abstractclass.abstractEvent.AbstractEvent	libsensorPy.abstractclass.abstractEvent.AbstractEvent-class.php
libsensorPy.abstractclass.abstractEvent.AbstractEvent.__metaclass__	abc.ABCMeta-class.php
libsensorPy.abstractclass.abstractEvent.AbstractEvent.notify_observers	libsensorPy.abstractclass.abstractEvent.AbstractEvent-class.php#notify_observers
libsensorPy.abstractclass.abstractEvent.AbstractEvent._abc_negative_cache	libsensorPy.abstractclass.abstractEvent.AbstractEvent-class.php#_abc_negative_cache
libsensorPy.abstractclass.abstractEvent.AbstractEvent.__init__	libsensorPy.abstractclass.abstractEvent.AbstractEvent-class.php#__init__
libsensorPy.abstractclass.abstractEvent.AbstractEvent._abc_cache	libsensorPy.abstractclass.abstractEvent.AbstractEvent-class.php#_abc_cache
libsensorPy.abstractclass.abstractEvent.AbstractEvent.__abstractmethods__	libsensorPy.abstractclass.abstractEvent.AbstractEvent-class.php#__abstractmethods__
libsensorPy.abstractclass.abstractEvent.AbstractEvent.attach	libsensorPy.abstractclass.abstractEvent.AbstractEvent-class.php#attach
libsensorPy.abstractclass.abstractEvent.AbstractEvent.detach	libsensorPy.abstractclass.abstractEvent.AbstractEvent-class.php#detach
libsensorPy.abstractclass.abstractEvent.AbstractEvent._abc_negative_cache_version	libsensorPy.abstractclass.abstractEvent.AbstractEvent-class.php#_abc_negative_cache_version
libsensorPy.abstractclass.abstractEvent.AbstractEvent._abc_registry	libsensorPy.abstractclass.abstractEvent.AbstractEvent-class.php#_abc_registry
libsensorPy.abstractclass.abstractSensorFactory.AbstractSensorFactory	libsensorPy.abstractclass.abstractSensorFactory.AbstractSensorFactory-class.php
libsensorPy.abstractclass.abstractSensorFactory.AbstractSensorFactory.__metaclass__	abc.ABCMeta-class.php
libsensorPy.abstractclass.abstractSensorFactory.AbstractSensorFactory._abc_negative_cache	libsensorPy.abstractclass.abstractSensorFactory.AbstractSensorFactory-class.php#_abc_negative_cache
libsensorPy.abstractclass.abstractSensorFactory.AbstractSensorFactory.createSensor	libsensorPy.abstractclass.abstractSensorFactory.AbstractSensorFactory-class.php#createSensor
libsensorPy.abstractclass.abstractSensorFactory.AbstractSensorFactory.__init__	libsensorPy.abstractclass.abstractSensorFactory.AbstractSensorFactory-class.php#__init__
libsensorPy.abstractclass.abstractSensorFactory.AbstractSensorFactory._abc_cache	libsensorPy.abstractclass.abstractSensorFactory.AbstractSensorFactory-class.php#_abc_cache
libsensorPy.abstractclass.abstractSensorFactory.AbstractSensorFactory.__abstractmethods__	libsensorPy.abstractclass.abstractSensorFactory.AbstractSensorFactory-class.php#__abstractmethods__
libsensorPy.abstractclass.abstractSensorFactory.AbstractSensorFactory._abc_negative_cache_version	libsensorPy.abstractclass.abstractSensorFactory.AbstractSensorFactory-class.php#_abc_negative_cache_version
libsensorPy.abstractclass.abstractSensorFactory.AbstractSensorFactory._abc_registry	libsensorPy.abstractclass.abstractSensorFactory.AbstractSensorFactory-class.php#_abc_registry
libsensorPy.abstractclass.abstractSensorFactory.AbstractSensorFactory.createEvent	libsensorPy.abstractclass.abstractSensorFactory.AbstractSensorFactory-class.php#createEvent
libsensorPy.abstractclass.accelerometerSensor.AccelerometerSensor	libsensorPy.abstractclass.accelerometerSensor.AccelerometerSensor-class.php
libsensorPy.abstractclass.accelerometerSensor.AccelerometerSensor.__metaclass__	libsensorPy.abstractclass.accelerometerSensor.AccelerometerSensor-class.php#__metaclass__
libsensorPy.abstractclass.sensor.Sensor.__del__	libsensorPy.abstractclass.sensor.Sensor-class.php#__del__
libsensorPy.abstractclass.sensor.Sensor.changeSetup	libsensorPy.abstractclass.sensor.Sensor-class.php#changeSetup
libsensorPy.abstractclass.accelerometerSensor.AccelerometerSensor.setup	libsensorPy.abstractclass.accelerometerSensor.AccelerometerSensor-class.php#setup
libsensorPy.abstractclass.accelerometerSensor.AccelerometerSensor.EARTH_GRAVITY_MS2	libsensorPy.abstractclass.accelerometerSensor.AccelerometerSensor-class.php#EARTH_GRAVITY_MS2
libsensorPy.abstractclass.accelerometerSensor.AccelerometerSensor.getAxesInMS2	libsensorPy.abstractclass.accelerometerSensor.AccelerometerSensor-class.php#getAxesInMS2
libsensorPy.abstractclass.accelerometerSensor.AccelerometerSensor.getAxes	libsensorPy.abstractclass.accelerometerSensor.AccelerometerSensor-class.php#getAxes
libsensorPy.abstractclass.accelerometerSensor.AccelerometerSensor.__init__	libsensorPy.abstractclass.accelerometerSensor.AccelerometerSensor-class.php#__init__
libsensorPy.abstractclass.actuator.Actuator	libsensorPy.abstractclass.actuator.Actuator-class.php
libsensorPy.abstractclass.actuator.Actuator.__metaclass__	libsensorPy.abstractclass.actuator.Actuator-class.php#__metaclass__
libsensorPy.abstractclass.actuator.Actuator.__del__	libsensorPy.abstractclass.actuator.Actuator-class.php#__del__
libsensorPy.abstractclass.actuator.Actuator.setup	libsensorPy.abstractclass.actuator.Actuator-class.php#setup
libsensorPy.abstractclass.actuator.Actuator.changeSetup	libsensorPy.abstractclass.actuator.Actuator-class.php#changeSetup
libsensorPy.abstractclass.actuator.Actuator.__init__	libsensorPy.abstractclass.actuator.Actuator-class.php#__init__
libsensorPy.abstractclass.altitudeSensor.AltitudeSensor	libsensorPy.abstractclass.altitudeSensor.AltitudeSensor-class.php
libsensorPy.abstractclass.altitudeSensor.AltitudeSensor.__metaclass__	libsensorPy.abstractclass.altitudeSensor.AltitudeSensor-class.php#__metaclass__
libsensorPy.abstractclass.sensor.Sensor.__del__	libsensorPy.abstractclass.sensor.Sensor-class.php#__del__
libsensorPy.abstractclass.sensor.Sensor.changeSetup	libsensorPy.abstractclass.sensor.Sensor-class.php#changeSetup
libsensorPy.abstractclass.altitudeSensor.AltitudeSensor.setup	libsensorPy.abstractclass.altitudeSensor.AltitudeSensor-class.php#setup
libsensorPy.abstractclass.altitudeSensor.AltitudeSensor.getAltitude	libsensorPy.abstractclass.altitudeSensor.AltitudeSensor-class.php#getAltitude
libsensorPy.abstractclass.altitudeSensor.AltitudeSensor.getAltitudeInCm	libsensorPy.abstractclass.altitudeSensor.AltitudeSensor-class.php#getAltitudeInCm
libsensorPy.abstractclass.altitudeSensor.AltitudeSensor._SEA_LEVEL_PRESSURE	libsensorPy.abstractclass.altitudeSensor.AltitudeSensor-class.php#_SEA_LEVEL_PRESSURE
libsensorPy.abstractclass.altitudeSensor.AltitudeSensor.__init__	libsensorPy.abstractclass.altitudeSensor.AltitudeSensor-class.php#__init__
libsensorPy.abstractclass.dcMotorActuator.DCMotorActuator	libsensorPy.abstractclass.dcMotorActuator.DCMotorActuator-class.php
libsensorPy.abstractclass.motorActuator.MotorActuator.rotate	libsensorPy.abstractclass.motorActuator.MotorActuator-class.php#rotate
libsensorPy.abstractclass.dcMotorActuator.DCMotorActuator.__metaclass__	libsensorPy.abstractclass.dcMotorActuator.DCMotorActuator-class.php#__metaclass__
libsensorPy.abstractclass.dcMotorActuator.DCMotorActuator.setStepSequence	libsensorPy.abstractclass.dcMotorActuator.DCMotorActuator-class.php#setStepSequence
libsensorPy.abstractclass.dcMotorActuator.DCMotorActuator.setDirection	libsensorPy.abstractclass.dcMotorActuator.DCMotorActuator-class.php#setDirection
libsensorPy.abstractclass.actuator.Actuator.__del__	libsensorPy.abstractclass.actuator.Actuator-class.php#__del__
libsensorPy.abstractclass.motorActuator.MotorActuator.setup	libsensorPy.abstractclass.motorActuator.MotorActuator-class.php#setup
libsensorPy.abstractclass.actuator.Actuator.changeSetup	libsensorPy.abstractclass.actuator.Actuator-class.php#changeSetup
libsensorPy.abstractclass.dcMotorActuator.DCMotorActuator.__init__	libsensorPy.abstractclass.dcMotorActuator.DCMotorActuator-class.php#__init__
libsensorPy.abstractclass.eventObserver.EventObserver	libsensorPy.abstractclass.eventObserver.EventObserver-class.php
libsensorPy.abstractclass.eventObserver.EventObserver.__metaclass__	abc.ABCMeta-class.php
libsensorPy.abstractclass.eventObserver.EventObserver._abc_negative_cache	libsensorPy.abstractclass.eventObserver.EventObserver-class.php#_abc_negative_cache
libsensorPy.abstractclass.eventObserver.EventObserver.remove_event	libsensorPy.abstractclass.eventObserver.EventObserver-class.php#remove_event
libsensorPy.abstractclass.eventObserver.EventObserver.__init__	libsensorPy.abstractclass.eventObserver.EventObserver-class.php#__init__
libsensorPy.abstractclass.eventObserver.EventObserver._abc_cache	libsensorPy.abstractclass.eventObserver.EventObserver-class.php#_abc_cache
libsensorPy.abstractclass.eventObserver.EventObserver.register_event	libsensorPy.abstractclass.eventObserver.EventObserver-class.php#register_event
libsensorPy.abstractclass.eventObserver.EventObserver.__abstractmethods__	libsensorPy.abstractclass.eventObserver.EventObserver-class.php#__abstractmethods__
libsensorPy.abstractclass.eventObserver.EventObserver.update	libsensorPy.abstractclass.eventObserver.EventObserver-class.php#update
libsensorPy.abstractclass.eventObserver.EventObserver._abc_negative_cache_version	libsensorPy.abstractclass.eventObserver.EventObserver-class.php#_abc_negative_cache_version
libsensorPy.abstractclass.eventObserver.EventObserver._abc_registry	libsensorPy.abstractclass.eventObserver.EventObserver-class.php#_abc_registry
libsensorPy.abstractclass.humiditySensor.HumiditySensor	libsensorPy.abstractclass.humiditySensor.HumiditySensor-class.php
libsensorPy.abstractclass.humiditySensor.HumiditySensor.__metaclass__	libsensorPy.abstractclass.humiditySensor.HumiditySensor-class.php#__metaclass__
libsensorPy.abstractclass.sensor.Sensor.__del__	libsensorPy.abstractclass.sensor.Sensor-class.php#__del__
libsensorPy.abstractclass.sensor.Sensor.changeSetup	libsensorPy.abstractclass.sensor.Sensor-class.php#changeSetup
libsensorPy.abstractclass.humiditySensor.HumiditySensor.setup	libsensorPy.abstractclass.humiditySensor.HumiditySensor-class.php#setup
libsensorPy.abstractclass.humiditySensor.HumiditySensor.getHumidity	libsensorPy.abstractclass.humiditySensor.HumiditySensor-class.php#getHumidity
libsensorPy.abstractclass.humiditySensor.HumiditySensor._bin2dec	libsensorPy.abstractclass.humiditySensor.HumiditySensor-class.php#_bin2dec
libsensorPy.abstractclass.humiditySensor.HumiditySensor.__init__	libsensorPy.abstractclass.humiditySensor.HumiditySensor-class.php#__init__
libsensorPy.abstractclass.lightSensor.LightSensor	libsensorPy.abstractclass.lightSensor.LightSensor-class.php
libsensorPy.abstractclass.lightSensor.LightSensor.getColorTemperatureInKelvin	libsensorPy.abstractclass.lightSensor.LightSensor-class.php#getColorTemperatureInKelvin
libsensorPy.abstractclass.lightSensor.LightSensor.getLux	libsensorPy.abstractclass.lightSensor.LightSensor-class.php#getLux
libsensorPy.abstractclass.lightSensor.LightSensor.__metaclass__	libsensorPy.abstractclass.lightSensor.LightSensor-class.php#__metaclass__
libsensorPy.abstractclass.sensor.Sensor.__del__	libsensorPy.abstractclass.sensor.Sensor-class.php#__del__
libsensorPy.abstractclass.lightSensor.LightSensor.setup	libsensorPy.abstractclass.lightSensor.LightSensor-class.php#setup
libsensorPy.abstractclass.lightSensor.LightSensor.getColorTemperature	libsensorPy.abstractclass.lightSensor.LightSensor-class.php#getColorTemperature
libsensorPy.abstractclass.sensor.Sensor.changeSetup	libsensorPy.abstractclass.sensor.Sensor-class.php#changeSetup
libsensorPy.abstractclass.lightSensor.LightSensor.__init__	libsensorPy.abstractclass.lightSensor.LightSensor-class.php#__init__
libsensorPy.abstractclass.magnetometerSensor.MagnetometerSensor	libsensorPy.abstractclass.magnetometerSensor.MagnetometerSensor-class.php
libsensorPy.abstractclass.magnetometerSensor.MagnetometerSensor.__metaclass__	libsensorPy.abstractclass.magnetometerSensor.MagnetometerSensor-class.php#__metaclass__
libsensorPy.abstractclass.sensor.Sensor.__del__	libsensorPy.abstractclass.sensor.Sensor-class.php#__del__
libsensorPy.abstractclass.magnetometerSensor.MagnetometerSensor.setup	libsensorPy.abstractclass.magnetometerSensor.MagnetometerSensor-class.php#setup
libsensorPy.abstractclass.magnetometerSensor.MagnetometerSensor.getMagnetic	libsensorPy.abstractclass.magnetometerSensor.MagnetometerSensor-class.php#getMagnetic
libsensorPy.abstractclass.sensor.Sensor.changeSetup	libsensorPy.abstractclass.sensor.Sensor-class.php#changeSetup
libsensorPy.abstractclass.magnetometerSensor.MagnetometerSensor.__init__	libsensorPy.abstractclass.magnetometerSensor.MagnetometerSensor-class.php#__init__
libsensorPy.abstractclass.motionSensor.MotionSensor	libsensorPy.abstractclass.motionSensor.MotionSensor-class.php
libsensorPy.abstractclass.motionSensor.MotionSensor.__metaclass__	libsensorPy.abstractclass.motionSensor.MotionSensor-class.php#__metaclass__
libsensorPy.abstractclass.sensor.Sensor.__del__	libsensorPy.abstractclass.sensor.Sensor-class.php#__del__
libsensorPy.abstractclass.motionSensor.MotionSensor.setup	libsensorPy.abstractclass.motionSensor.MotionSensor-class.php#setup
libsensorPy.abstractclass.motionSensor.MotionSensor.isMotionDetected	libsensorPy.abstractclass.motionSensor.MotionSensor-class.php#isMotionDetected
libsensorPy.abstractclass.sensor.Sensor.changeSetup	libsensorPy.abstractclass.sensor.Sensor-class.php#changeSetup
libsensorPy.abstractclass.motionSensor.MotionSensor.__init__	libsensorPy.abstractclass.motionSensor.MotionSensor-class.php#__init__
libsensorPy.abstractclass.motorActuator.MotorActuator	libsensorPy.abstractclass.motorActuator.MotorActuator-class.php
libsensorPy.abstractclass.motorActuator.MotorActuator.rotate	libsensorPy.abstractclass.motorActuator.MotorActuator-class.php#rotate
libsensorPy.abstractclass.motorActuator.MotorActuator.__metaclass__	libsensorPy.abstractclass.motorActuator.MotorActuator-class.php#__metaclass__
libsensorPy.abstractclass.motorActuator.MotorActuator.setDirection	libsensorPy.abstractclass.motorActuator.MotorActuator-class.php#setDirection
libsensorPy.abstractclass.actuator.Actuator.__del__	libsensorPy.abstractclass.actuator.Actuator-class.php#__del__
libsensorPy.abstractclass.motorActuator.MotorActuator.setup	libsensorPy.abstractclass.motorActuator.MotorActuator-class.php#setup
libsensorPy.abstractclass.actuator.Actuator.changeSetup	libsensorPy.abstractclass.actuator.Actuator-class.php#changeSetup
libsensorPy.abstractclass.motorActuator.MotorActuator.__init__	libsensorPy.abstractclass.motorActuator.MotorActuator-class.php#__init__
libsensorPy.abstractclass.pressureSensor.PressureSensor	libsensorPy.abstractclass.pressureSensor.PressureSensor-class.php
libsensorPy.abstractclass.pressureSensor.PressureSensor.__metaclass__	libsensorPy.abstractclass.pressureSensor.PressureSensor-class.php#__metaclass__
libsensorPy.abstractclass.pressureSensor.PressureSensor.__init__	libsensorPy.abstractclass.pressureSensor.PressureSensor-class.php#__init__
libsensorPy.abstractclass.pressureSensor.PressureSensor.getPressureInPsi	libsensorPy.abstractclass.pressureSensor.PressureSensor-class.php#getPressureInPsi
libsensorPy.abstractclass.pressureSensor.PressureSensor.getPressureInBar	libsensorPy.abstractclass.pressureSensor.PressureSensor-class.php#getPressureInBar
libsensorPy.abstractclass.sensor.Sensor.__del__	libsensorPy.abstractclass.sensor.Sensor-class.php#__del__
libsensorPy.abstractclass.pressureSensor.PressureSensor.getPressure	libsensorPy.abstractclass.pressureSensor.PressureSensor-class.php#getPressure
libsensorPy.abstractclass.pressureSensor.PressureSensor.getPressureInMmhg	libsensorPy.abstractclass.pressureSensor.PressureSensor-class.php#getPressureInMmhg
libsensorPy.abstractclass.sensor.Sensor.changeSetup	libsensorPy.abstractclass.sensor.Sensor-class.php#changeSetup
libsensorPy.abstractclass.pressureSensor.PressureSensor.setup	libsensorPy.abstractclass.pressureSensor.PressureSensor-class.php#setup
libsensorPy.abstractclass.pressureSensor.PressureSensor.getPressureInNm2	libsensorPy.abstractclass.pressureSensor.PressureSensor-class.php#getPressureInNm2
libsensorPy.abstractclass.sensor.Sensor	libsensorPy.abstractclass.sensor.Sensor-class.php
libsensorPy.abstractclass.sensor.Sensor.__metaclass__	libsensorPy.abstractclass.sensor.Sensor-class.php#__metaclass__
libsensorPy.abstractclass.sensor.Sensor.__del__	libsensorPy.abstractclass.sensor.Sensor-class.php#__del__
libsensorPy.abstractclass.sensor.Sensor.setup	libsensorPy.abstractclass.sensor.Sensor-class.php#setup
libsensorPy.abstractclass.sensor.Sensor.changeSetup	libsensorPy.abstractclass.sensor.Sensor-class.php#changeSetup
libsensorPy.abstractclass.sensor.Sensor.__init__	libsensorPy.abstractclass.sensor.Sensor-class.php#__init__
libsensorPy.abstractclass.servoMotorActuator.ServoMotorActuator	libsensorPy.abstractclass.servoMotorActuator.ServoMotorActuator-class.php
libsensorPy.abstractclass.motorActuator.MotorActuator.rotate	libsensorPy.abstractclass.motorActuator.MotorActuator-class.php#rotate
libsensorPy.abstractclass.servoMotorActuator.ServoMotorActuator.__metaclass__	libsensorPy.abstractclass.servoMotorActuator.ServoMotorActuator-class.php#__metaclass__
libsensorPy.abstractclass.servoMotorActuator.ServoMotorActuator.setDirection	libsensorPy.abstractclass.servoMotorActuator.ServoMotorActuator-class.php#setDirection
libsensorPy.abstractclass.actuator.Actuator.__del__	libsensorPy.abstractclass.actuator.Actuator-class.php#__del__
libsensorPy.abstractclass.servoMotorActuator.ServoMotorActuator.setAngle	libsensorPy.abstractclass.servoMotorActuator.ServoMotorActuator-class.php#setAngle
libsensorPy.abstractclass.motorActuator.MotorActuator.setup	libsensorPy.abstractclass.motorActuator.MotorActuator-class.php#setup
libsensorPy.abstractclass.actuator.Actuator.changeSetup	libsensorPy.abstractclass.actuator.Actuator-class.php#changeSetup
libsensorPy.abstractclass.servoMotorActuator.ServoMotorActuator.__init__	libsensorPy.abstractclass.servoMotorActuator.ServoMotorActuator-class.php#__init__
libsensorPy.abstractclass.stepperMotorActuator.StepperMotorActuator	libsensorPy.abstractclass.stepperMotorActuator.StepperMotorActuator-class.php
libsensorPy.abstractclass.stepperMotorActuator.StepperMotorActuator.__metaclass__	libsensorPy.abstractclass.stepperMotorActuator.StepperMotorActuator-class.php#__metaclass__
libsensorPy.abstractclass.stepperMotorActuator.StepperMotorActuator.__init__	libsensorPy.abstractclass.stepperMotorActuator.StepperMotorActuator-class.php#__init__
libsensorPy.abstractclass.motorActuator.MotorActuator.setDirection	libsensorPy.abstractclass.motorActuator.MotorActuator-class.php#setDirection
libsensorPy.abstractclass.stepperMotorActuator.StepperMotorActuator.setStepSequence	libsensorPy.abstractclass.stepperMotorActuator.StepperMotorActuator-class.php#setStepSequence
libsensorPy.abstractclass.actuator.Actuator.__del__	libsensorPy.abstractclass.actuator.Actuator-class.php#__del__
libsensorPy.abstractclass.stepperMotorActuator.StepperMotorActuator.setDirectionAndVelocity	libsensorPy.abstractclass.stepperMotorActuator.StepperMotorActuator-class.php#setDirectionAndVelocity
libsensorPy.abstractclass.actuator.Actuator.changeSetup	libsensorPy.abstractclass.actuator.Actuator-class.php#changeSetup
libsensorPy.abstractclass.motorActuator.MotorActuator.rotate	libsensorPy.abstractclass.motorActuator.MotorActuator-class.php#rotate
libsensorPy.abstractclass.motorActuator.MotorActuator.setup	libsensorPy.abstractclass.motorActuator.MotorActuator-class.php#setup
libsensorPy.abstractclass.temperatureSensor.TemperatureSensor	libsensorPy.abstractclass.temperatureSensor.TemperatureSensor-class.php
libsensorPy.abstractclass.temperatureSensor.TemperatureSensor.__metaclass__	libsensorPy.abstractclass.temperatureSensor.TemperatureSensor-class.php#__metaclass__
libsensorPy.abstractclass.temperatureSensor.TemperatureSensor.__init__	libsensorPy.abstractclass.temperatureSensor.TemperatureSensor-class.php#__init__
libsensorPy.abstractclass.temperatureSensor.TemperatureSensor.getTemperature	libsensorPy.abstractclass.temperatureSensor.TemperatureSensor-class.php#getTemperature
libsensorPy.abstractclass.temperatureSensor.TemperatureSensor.getTemperatureInFahrenheit	libsensorPy.abstractclass.temperatureSensor.TemperatureSensor-class.php#getTemperatureInFahrenheit
libsensorPy.abstractclass.sensor.Sensor.__del__	libsensorPy.abstractclass.sensor.Sensor-class.php#__del__
libsensorPy.abstractclass.sensor.Sensor.changeSetup	libsensorPy.abstractclass.sensor.Sensor-class.php#changeSetup
libsensorPy.abstractclass.temperatureSensor.TemperatureSensor.getTemperatureInKelvin	libsensorPy.abstractclass.temperatureSensor.TemperatureSensor-class.php#getTemperatureInKelvin
libsensorPy.abstractclass.temperatureSensor.TemperatureSensor.setup	libsensorPy.abstractclass.temperatureSensor.TemperatureSensor-class.php#setup
libsensorPy.abstractclass.temperatureSensor.TemperatureSensor._bin2dec	libsensorPy.abstractclass.temperatureSensor.TemperatureSensor-class.php#_bin2dec
libsensorPy.abstractclass.ultrasonicSensor.UltrasonicSensor	libsensorPy.abstractclass.ultrasonicSensor.UltrasonicSensor-class.php
libsensorPy.abstractclass.ultrasonicSensor.UltrasonicSensor.__metaclass__	libsensorPy.abstractclass.ultrasonicSensor.UltrasonicSensor-class.php#__metaclass__
libsensorPy.abstractclass.ultrasonicSensor.UltrasonicSensor.distance_in_cm	libsensorPy.abstractclass.ultrasonicSensor.UltrasonicSensor-class.php#distance_in_cm
libsensorPy.abstractclass.sensor.Sensor.__del__	libsensorPy.abstractclass.sensor.Sensor-class.php#__del__
libsensorPy.abstractclass.sensor.Sensor.changeSetup	libsensorPy.abstractclass.sensor.Sensor-class.php#changeSetup
libsensorPy.abstractclass.ultrasonicSensor.UltrasonicSensor.setup	libsensorPy.abstractclass.ultrasonicSensor.UltrasonicSensor-class.php#setup
libsensorPy.abstractclass.ultrasonicSensor.UltrasonicSensor.__init__	libsensorPy.abstractclass.ultrasonicSensor.UltrasonicSensor-class.php#__init__
libsensorPy.abstractclass.ultrasonicSensor.UltrasonicSensor._bin2dec	libsensorPy.abstractclass.ultrasonicSensor.UltrasonicSensor-class.php#_bin2dec
libsensorPy.abstractclass.ultrasonicSensor.UltrasonicSensor.distance_in_inches	libsensorPy.abstractclass.ultrasonicSensor.UltrasonicSensor-class.php#distance_in_inches
libsensorPy.compositesensor.bmp085Composite.BMP085Composite	libsensorPy.compositesensor.bmp085Composite.BMP085Composite-class.php
libsensorPy.abstractclass.altitudeSensor.AltitudeSensor.__metaclass__	libsensorPy.abstractclass.altitudeSensor.AltitudeSensor-class.php#__metaclass__
libsensorPy.abstractclass.altitudeSensor.AltitudeSensor.getAltitudeInCm	libsensorPy.abstractclass.altitudeSensor.AltitudeSensor-class.php#getAltitudeInCm
libsensorPy.abstractclass.altitudeSensor.AltitudeSensor._SEA_LEVEL_PRESSURE	libsensorPy.abstractclass.altitudeSensor.AltitudeSensor-class.php#_SEA_LEVEL_PRESSURE
libsensorPy.compositesensor.bmp085Composite.BMP085Composite.__init__	libsensorPy.compositesensor.bmp085Composite.BMP085Composite-class.php#__init__
libsensorPy.abstractclass.pressureSensor.PressureSensor.getPressureInPsi	libsensorPy.abstractclass.pressureSensor.PressureSensor-class.php#getPressureInPsi
libsensorPy.abstractclass.pressureSensor.PressureSensor.getPressureInBar	libsensorPy.abstractclass.pressureSensor.PressureSensor-class.php#getPressureInBar
libsensorPy.compositesensor.bmp085Composite.BMP085Composite.getTemperature	libsensorPy.compositesensor.bmp085Composite.BMP085Composite-class.php#getTemperature
libsensorPy.compositesensor.bmp085Composite.BMP085Composite.add	libsensorPy.compositesensor.bmp085Composite.BMP085Composite-class.php#add
libsensorPy.compositesensor.bmp085Composite.BMP085Composite.getTemperatureInFahrenheit	libsensorPy.compositesensor.bmp085Composite.BMP085Composite-class.php#getTemperatureInFahrenheit
libsensorPy.abstractclass.sensor.Sensor.__del__	libsensorPy.abstractclass.sensor.Sensor-class.php#__del__
libsensorPy.compositesensor.bmp085Composite.BMP085Composite.getAltitude	libsensorPy.compositesensor.bmp085Composite.BMP085Composite-class.php#getAltitude
libsensorPy.compositesensor.bmp085Composite.BMP085Composite.getPressure	libsensorPy.compositesensor.bmp085Composite.BMP085Composite-class.php#getPressure
libsensorPy.abstractclass.pressureSensor.PressureSensor.getPressureInMmhg	libsensorPy.abstractclass.pressureSensor.PressureSensor-class.php#getPressureInMmhg
libsensorPy.compositesensor.bmp085Composite.BMP085Composite.changeSetup	libsensorPy.compositesensor.bmp085Composite.BMP085Composite-class.php#changeSetup
libsensorPy.compositesensor.bmp085Composite.BMP085Composite.getTemperatureInKelvin	libsensorPy.compositesensor.bmp085Composite.BMP085Composite-class.php#getTemperatureInKelvin
libsensorPy.compositesensor.bmp085Composite.BMP085Composite.setup	libsensorPy.compositesensor.bmp085Composite.BMP085Composite-class.php#setup
libsensorPy.abstractclass.pressureSensor.PressureSensor.getPressureInNm2	libsensorPy.abstractclass.pressureSensor.PressureSensor-class.php#getPressureInNm2
libsensorPy.abstractclass.temperatureSensor.TemperatureSensor._bin2dec	libsensorPy.abstractclass.temperatureSensor.TemperatureSensor-class.php#_bin2dec
libsensorPy.compositesensor.dht11Composite.DHT11Composite	libsensorPy.compositesensor.dht11Composite.DHT11Composite-class.php
libsensorPy.abstractclass.temperatureSensor.TemperatureSensor.__metaclass__	libsensorPy.abstractclass.temperatureSensor.TemperatureSensor-class.php#__metaclass__
libsensorPy.compositesensor.dht11Composite.DHT11Composite.__init__	libsensorPy.compositesensor.dht11Composite.DHT11Composite-class.php#__init__
libsensorPy.compositesensor.dht11Composite.DHT11Composite.getTemperature	libsensorPy.compositesensor.dht11Composite.DHT11Composite-class.php#getTemperature
libsensorPy.compositesensor.dht11Composite.DHT11Composite.add	libsensorPy.compositesensor.dht11Composite.DHT11Composite-class.php#add
libsensorPy.compositesensor.dht11Composite.DHT11Composite.getTemperatureInFahrenheit	libsensorPy.compositesensor.dht11Composite.DHT11Composite-class.php#getTemperatureInFahrenheit
libsensorPy.abstractclass.sensor.Sensor.__del__	libsensorPy.abstractclass.sensor.Sensor-class.php#__del__
libsensorPy.compositesensor.dht11Composite.DHT11Composite.getHumidity	libsensorPy.compositesensor.dht11Composite.DHT11Composite-class.php#getHumidity
libsensorPy.compositesensor.dht11Composite.DHT11Composite.changeSetup	libsensorPy.compositesensor.dht11Composite.DHT11Composite-class.php#changeSetup
libsensorPy.compositesensor.dht11Composite.DHT11Composite.getTemperatureInKelvin	libsensorPy.compositesensor.dht11Composite.DHT11Composite-class.php#getTemperatureInKelvin
libsensorPy.compositesensor.dht11Composite.DHT11Composite.setup	libsensorPy.compositesensor.dht11Composite.DHT11Composite-class.php#setup
libsensorPy.abstractclass.temperatureSensor.TemperatureSensor._bin2dec	libsensorPy.abstractclass.temperatureSensor.TemperatureSensor-class.php#_bin2dec
libsensorPy.compositesensor.dht22Composite.DHT22Composite	libsensorPy.compositesensor.dht22Composite.DHT22Composite-class.php
libsensorPy.abstractclass.temperatureSensor.TemperatureSensor.__metaclass__	libsensorPy.abstractclass.temperatureSensor.TemperatureSensor-class.php#__metaclass__
libsensorPy.compositesensor.dht22Composite.DHT22Composite.__init__	libsensorPy.compositesensor.dht22Composite.DHT22Composite-class.php#__init__
libsensorPy.compositesensor.dht22Composite.DHT22Composite.getTemperature	libsensorPy.compositesensor.dht22Composite.DHT22Composite-class.php#getTemperature
libsensorPy.compositesensor.dht22Composite.DHT22Composite.add	libsensorPy.compositesensor.dht22Composite.DHT22Composite-class.php#add
libsensorPy.compositesensor.dht22Composite.DHT22Composite.getTemperatureInFahrenheit	libsensorPy.compositesensor.dht22Composite.DHT22Composite-class.php#getTemperatureInFahrenheit
libsensorPy.abstractclass.sensor.Sensor.__del__	libsensorPy.abstractclass.sensor.Sensor-class.php#__del__
libsensorPy.compositesensor.dht22Composite.DHT22Composite.getHumidity	libsensorPy.compositesensor.dht22Composite.DHT22Composite-class.php#getHumidity
libsensorPy.compositesensor.dht22Composite.DHT22Composite.changeSetup	libsensorPy.compositesensor.dht22Composite.DHT22Composite-class.php#changeSetup
libsensorPy.compositesensor.dht22Composite.DHT22Composite.getTemperatureInKelvin	libsensorPy.compositesensor.dht22Composite.DHT22Composite-class.php#getTemperatureInKelvin
libsensorPy.compositesensor.dht22Composite.DHT22Composite.setup	libsensorPy.compositesensor.dht22Composite.DHT22Composite-class.php#setup
libsensorPy.abstractclass.temperatureSensor.TemperatureSensor._bin2dec	libsensorPy.abstractclass.temperatureSensor.TemperatureSensor-class.php#_bin2dec
libsensorPy.compositesensor.lsm303dComposite.LSM303DComposite	libsensorPy.compositesensor.lsm303dComposite.LSM303DComposite-class.php
libsensorPy.abstractclass.accelerometerSensor.AccelerometerSensor.__metaclass__	libsensorPy.abstractclass.accelerometerSensor.AccelerometerSensor-class.php#__metaclass__
libsensorPy.compositesensor.lsm303dComposite.LSM303DComposite.getAxes	libsensorPy.compositesensor.lsm303dComposite.LSM303DComposite-class.php#getAxes
libsensorPy.compositesensor.lsm303dComposite.LSM303DComposite.__init__	libsensorPy.compositesensor.lsm303dComposite.LSM303DComposite-class.php#__init__
libsensorPy.abstractclass.accelerometerSensor.AccelerometerSensor.EARTH_GRAVITY_MS2	libsensorPy.abstractclass.accelerometerSensor.AccelerometerSensor-class.php#EARTH_GRAVITY_MS2
libsensorPy.compositesensor.lsm303dComposite.LSM303DComposite.add	libsensorPy.compositesensor.lsm303dComposite.LSM303DComposite-class.php#add
libsensorPy.compositesensor.lsm303dComposite.LSM303DComposite.getMagnetic	libsensorPy.compositesensor.lsm303dComposite.LSM303DComposite-class.php#getMagnetic
libsensorPy.abstractclass.sensor.Sensor.__del__	libsensorPy.abstractclass.sensor.Sensor-class.php#__del__
libsensorPy.compositesensor.lsm303dComposite.LSM303DComposite.changeSetup	libsensorPy.compositesensor.lsm303dComposite.LSM303DComposite-class.php#changeSetup
libsensorPy.compositesensor.lsm303dComposite.LSM303DComposite.setup	libsensorPy.compositesensor.lsm303dComposite.LSM303DComposite-class.php#setup
libsensorPy.abstractclass.accelerometerSensor.AccelerometerSensor.getAxesInMS2	libsensorPy.abstractclass.accelerometerSensor.AccelerometerSensor-class.php#getAxesInMS2
libsensorPy.concreteactuator.stepper28BJY48.Stepper28BJY48	libsensorPy.concreteactuator.stepper28BJY48.Stepper28BJY48-class.php
libsensorPy.abstractclass.stepperMotorActuator.StepperMotorActuator.__metaclass__	libsensorPy.abstractclass.stepperMotorActuator.StepperMotorActuator-class.php#__metaclass__
libsensorPy.concreteactuator.stepper28BJY48.Stepper28BJY48.FOUR_STEP_SEQUENCE	libsensorPy.concreteactuator.stepper28BJY48.Stepper28BJY48-class.php#FOUR_STEP_SEQUENCE
libsensorPy.concreteactuator.stepper28BJY48.Stepper28BJY48.setWaitTime	libsensorPy.concreteactuator.stepper28BJY48.Stepper28BJY48-class.php#setWaitTime
libsensorPy.concreteactuator.stepper28BJY48.Stepper28BJY48.EIGHT_STEP_SEQUENCE	libsensorPy.concreteactuator.stepper28BJY48.Stepper28BJY48-class.php#EIGHT_STEP_SEQUENCE
libsensorPy.concreteactuator.stepper28BJY48.Stepper28BJY48.__init__	libsensorPy.concreteactuator.stepper28BJY48.Stepper28BJY48-class.php#__init__
libsensorPy.abstractclass.motorActuator.MotorActuator.setDirection	libsensorPy.abstractclass.motorActuator.MotorActuator-class.php#setDirection
libsensorPy.concreteactuator.stepper28BJY48.Stepper28BJY48.CLOCKWISE	libsensorPy.concreteactuator.stepper28BJY48.Stepper28BJY48-class.php#CLOCKWISE
libsensorPy.concreteactuator.stepper28BJY48.Stepper28BJY48.ANTI_CLOCKWISE	libsensorPy.concreteactuator.stepper28BJY48.Stepper28BJY48-class.php#ANTI_CLOCKWISE
libsensorPy.concreteactuator.stepper28BJY48.Stepper28BJY48.FASTER_CLOCKWISE	libsensorPy.concreteactuator.stepper28BJY48.Stepper28BJY48-class.php#FASTER_CLOCKWISE
libsensorPy.concreteactuator.stepper28BJY48.Stepper28BJY48.setStepSequence	libsensorPy.concreteactuator.stepper28BJY48.Stepper28BJY48-class.php#setStepSequence
libsensorPy.abstractclass.actuator.Actuator.__del__	libsensorPy.abstractclass.actuator.Actuator-class.php#__del__
libsensorPy.concreteactuator.stepper28BJY48.Stepper28BJY48.setDirectionAndVelocity	libsensorPy.concreteactuator.stepper28BJY48.Stepper28BJY48-class.php#setDirectionAndVelocity
libsensorPy.concreteactuator.stepper28BJY48.Stepper28BJY48.changeSetup	libsensorPy.concreteactuator.stepper28BJY48.Stepper28BJY48-class.php#changeSetup
libsensorPy.concreteactuator.stepper28BJY48.Stepper28BJY48.rotate	libsensorPy.concreteactuator.stepper28BJY48.Stepper28BJY48-class.php#rotate
libsensorPy.concreteactuator.stepper28BJY48.Stepper28BJY48.setup	libsensorPy.concreteactuator.stepper28BJY48.Stepper28BJY48-class.php#setup
libsensorPy.concreteactuator.stepper28BJY48.Stepper28BJY48.FASTER_ANTI_CLOCKWISE	libsensorPy.concreteactuator.stepper28BJY48.Stepper28BJY48-class.php#FASTER_ANTI_CLOCKWISE
libsensorPy.concreteevent.temperatureEvent.TemperatureEvent	libsensorPy.concreteevent.temperatureEvent.TemperatureEvent-class.php
libsensorPy.abstractclass.abstractEvent.AbstractEvent.__metaclass__	abc.ABCMeta-class.php
libsensorPy.abstractclass.abstractEvent.AbstractEvent.notify_observers	libsensorPy.abstractclass.abstractEvent.AbstractEvent-class.php#notify_observers
libsensorPy.abstractclass.abstractEvent.AbstractEvent._abc_negative_cache	libsensorPy.abstractclass.abstractEvent.AbstractEvent-class.php#_abc_negative_cache
libsensorPy.concreteevent.temperatureEvent.TemperatureEvent.__init__	libsensorPy.concreteevent.temperatureEvent.TemperatureEvent-class.php#__init__
libsensorPy.abstractclass.abstractEvent.AbstractEvent._abc_cache	libsensorPy.abstractclass.abstractEvent.AbstractEvent-class.php#_abc_cache
libsensorPy.concreteevent.temperatureEvent.TemperatureEvent.set_measurement	libsensorPy.concreteevent.temperatureEvent.TemperatureEvent-class.php#set_measurement
libsensorPy.abstractclass.abstractEvent.AbstractEvent.__abstractmethods__	libsensorPy.abstractclass.abstractEvent.AbstractEvent-class.php#__abstractmethods__
libsensorPy.concreteevent.temperatureEvent.TemperatureEvent.getTemperature	libsensorPy.concreteevent.temperatureEvent.TemperatureEvent-class.php#getTemperature
libsensorPy.abstractclass.abstractEvent.AbstractEvent.attach	libsensorPy.abstractclass.abstractEvent.AbstractEvent-class.php#attach
libsensorPy.abstractclass.abstractEvent.AbstractEvent.detach	libsensorPy.abstractclass.abstractEvent.AbstractEvent-class.php#detach
libsensorPy.abstractclass.abstractEvent.AbstractEvent._abc_negative_cache_version	libsensorPy.abstractclass.abstractEvent.AbstractEvent-class.php#_abc_negative_cache_version
libsensorPy.abstractclass.abstractEvent.AbstractEvent._abc_registry	libsensorPy.abstractclass.abstractEvent.AbstractEvent-class.php#_abc_registry
libsensorPy.concretefactory.accelerometerSensorFactory.AccelerometerSensorFactory	libsensorPy.concretefactory.accelerometerSensorFactory.AccelerometerSensorFactory-class.php
libsensorPy.abstractclass.abstractSensorFactory.AbstractSensorFactory.__metaclass__	abc.ABCMeta-class.php
libsensorPy.abstractclass.abstractSensorFactory.AbstractSensorFactory._abc_negative_cache	libsensorPy.abstractclass.abstractSensorFactory.AbstractSensorFactory-class.php#_abc_negative_cache
libsensorPy.concretefactory.accelerometerSensorFactory.AccelerometerSensorFactory.createSensor	libsensorPy.concretefactory.accelerometerSensorFactory.AccelerometerSensorFactory-class.php#createSensor
libsensorPy.concretefactory.accelerometerSensorFactory.AccelerometerSensorFactory.__init__	libsensorPy.concretefactory.accelerometerSensorFactory.AccelerometerSensorFactory-class.php#__init__
libsensorPy.abstractclass.abstractSensorFactory.AbstractSensorFactory._abc_cache	libsensorPy.abstractclass.abstractSensorFactory.AbstractSensorFactory-class.php#_abc_cache
libsensorPy.abstractclass.abstractSensorFactory.AbstractSensorFactory.__abstractmethods__	libsensorPy.abstractclass.abstractSensorFactory.AbstractSensorFactory-class.php#__abstractmethods__
libsensorPy.abstractclass.abstractSensorFactory.AbstractSensorFactory._abc_negative_cache_version	libsensorPy.abstractclass.abstractSensorFactory.AbstractSensorFactory-class.php#_abc_negative_cache_version
libsensorPy.abstractclass.abstractSensorFactory.AbstractSensorFactory._abc_registry	libsensorPy.abstractclass.abstractSensorFactory.AbstractSensorFactory-class.php#_abc_registry
libsensorPy.concretefactory.accelerometerSensorFactory.AccelerometerSensorFactory.createEvent	libsensorPy.concretefactory.accelerometerSensorFactory.AccelerometerSensorFactory-class.php#createEvent
libsensorPy.concretefactory.altitudeSensorFactory.AltitudeSensorFactory	libsensorPy.concretefactory.altitudeSensorFactory.AltitudeSensorFactory-class.php
libsensorPy.abstractclass.abstractSensorFactory.AbstractSensorFactory.__metaclass__	abc.ABCMeta-class.php
libsensorPy.abstractclass.abstractSensorFactory.AbstractSensorFactory._abc_negative_cache	libsensorPy.abstractclass.abstractSensorFactory.AbstractSensorFactory-class.php#_abc_negative_cache
libsensorPy.concretefactory.altitudeSensorFactory.AltitudeSensorFactory.createSensor	libsensorPy.concretefactory.altitudeSensorFactory.AltitudeSensorFactory-class.php#createSensor
libsensorPy.concretefactory.altitudeSensorFactory.AltitudeSensorFactory.__init__	libsensorPy.concretefactory.altitudeSensorFactory.AltitudeSensorFactory-class.php#__init__
libsensorPy.abstractclass.abstractSensorFactory.AbstractSensorFactory._abc_cache	libsensorPy.abstractclass.abstractSensorFactory.AbstractSensorFactory-class.php#_abc_cache
libsensorPy.abstractclass.abstractSensorFactory.AbstractSensorFactory.__abstractmethods__	libsensorPy.abstractclass.abstractSensorFactory.AbstractSensorFactory-class.php#__abstractmethods__
libsensorPy.abstractclass.abstractSensorFactory.AbstractSensorFactory._abc_negative_cache_version	libsensorPy.abstractclass.abstractSensorFactory.AbstractSensorFactory-class.php#_abc_negative_cache_version
libsensorPy.abstractclass.abstractSensorFactory.AbstractSensorFactory._abc_registry	libsensorPy.abstractclass.abstractSensorFactory.AbstractSensorFactory-class.php#_abc_registry
libsensorPy.concretefactory.altitudeSensorFactory.AltitudeSensorFactory.createEvent	libsensorPy.concretefactory.altitudeSensorFactory.AltitudeSensorFactory-class.php#createEvent
libsensorPy.concretefactory.compositeSensorFactory.CompositeSensorFactory	libsensorPy.concretefactory.compositeSensorFactory.CompositeSensorFactory-class.php
libsensorPy.abstractclass.abstractSensorFactory.AbstractSensorFactory.__metaclass__	abc.ABCMeta-class.php
libsensorPy.abstractclass.abstractSensorFactory.AbstractSensorFactory._abc_negative_cache	libsensorPy.abstractclass.abstractSensorFactory.AbstractSensorFactory-class.php#_abc_negative_cache
libsensorPy.concretefactory.compositeSensorFactory.CompositeSensorFactory.createSensor	libsensorPy.concretefactory.compositeSensorFactory.CompositeSensorFactory-class.php#createSensor
libsensorPy.concretefactory.compositeSensorFactory.CompositeSensorFactory.__init__	libsensorPy.concretefactory.compositeSensorFactory.CompositeSensorFactory-class.php#__init__
libsensorPy.abstractclass.abstractSensorFactory.AbstractSensorFactory._abc_cache	libsensorPy.abstractclass.abstractSensorFactory.AbstractSensorFactory-class.php#_abc_cache
libsensorPy.abstractclass.abstractSensorFactory.AbstractSensorFactory.__abstractmethods__	libsensorPy.abstractclass.abstractSensorFactory.AbstractSensorFactory-class.php#__abstractmethods__
libsensorPy.abstractclass.abstractSensorFactory.AbstractSensorFactory._abc_negative_cache_version	libsensorPy.abstractclass.abstractSensorFactory.AbstractSensorFactory-class.php#_abc_negative_cache_version
libsensorPy.abstractclass.abstractSensorFactory.AbstractSensorFactory._abc_registry	libsensorPy.abstractclass.abstractSensorFactory.AbstractSensorFactory-class.php#_abc_registry
libsensorPy.concretefactory.compositeSensorFactory.CompositeSensorFactory.createEvent	libsensorPy.concretefactory.compositeSensorFactory.CompositeSensorFactory-class.php#createEvent
libsensorPy.concretefactory.humiditySensorFactory.HumididtySensorFactory	libsensorPy.concretefactory.humiditySensorFactory.HumididtySensorFactory-class.php
libsensorPy.abstractclass.abstractSensorFactory.AbstractSensorFactory.__metaclass__	abc.ABCMeta-class.php
libsensorPy.abstractclass.abstractSensorFactory.AbstractSensorFactory._abc_negative_cache	libsensorPy.abstractclass.abstractSensorFactory.AbstractSensorFactory-class.php#_abc_negative_cache
libsensorPy.concretefactory.humiditySensorFactory.HumididtySensorFactory.createSensor	libsensorPy.concretefactory.humiditySensorFactory.HumididtySensorFactory-class.php#createSensor
libsensorPy.concretefactory.humiditySensorFactory.HumididtySensorFactory.__init__	libsensorPy.concretefactory.humiditySensorFactory.HumididtySensorFactory-class.php#__init__
libsensorPy.abstractclass.abstractSensorFactory.AbstractSensorFactory._abc_cache	libsensorPy.abstractclass.abstractSensorFactory.AbstractSensorFactory-class.php#_abc_cache
libsensorPy.abstractclass.abstractSensorFactory.AbstractSensorFactory.__abstractmethods__	libsensorPy.abstractclass.abstractSensorFactory.AbstractSensorFactory-class.php#__abstractmethods__
libsensorPy.abstractclass.abstractSensorFactory.AbstractSensorFactory._abc_negative_cache_version	libsensorPy.abstractclass.abstractSensorFactory.AbstractSensorFactory-class.php#_abc_negative_cache_version
libsensorPy.abstractclass.abstractSensorFactory.AbstractSensorFactory._abc_registry	libsensorPy.abstractclass.abstractSensorFactory.AbstractSensorFactory-class.php#_abc_registry
libsensorPy.concretefactory.humiditySensorFactory.HumididtySensorFactory.createEvent	libsensorPy.concretefactory.humiditySensorFactory.HumididtySensorFactory-class.php#createEvent
libsensorPy.concretefactory.lightSensorFactory.LightSensorFactory	libsensorPy.concretefactory.lightSensorFactory.LightSensorFactory-class.php
libsensorPy.abstractclass.abstractSensorFactory.AbstractSensorFactory.__metaclass__	abc.ABCMeta-class.php
libsensorPy.abstractclass.abstractSensorFactory.AbstractSensorFactory._abc_negative_cache	libsensorPy.abstractclass.abstractSensorFactory.AbstractSensorFactory-class.php#_abc_negative_cache
libsensorPy.concretefactory.lightSensorFactory.LightSensorFactory.createSensor	libsensorPy.concretefactory.lightSensorFactory.LightSensorFactory-class.php#createSensor
libsensorPy.concretefactory.lightSensorFactory.LightSensorFactory.__init__	libsensorPy.concretefactory.lightSensorFactory.LightSensorFactory-class.php#__init__
libsensorPy.abstractclass.abstractSensorFactory.AbstractSensorFactory._abc_cache	libsensorPy.abstractclass.abstractSensorFactory.AbstractSensorFactory-class.php#_abc_cache
libsensorPy.abstractclass.abstractSensorFactory.AbstractSensorFactory.__abstractmethods__	libsensorPy.abstractclass.abstractSensorFactory.AbstractSensorFactory-class.php#__abstractmethods__
libsensorPy.abstractclass.abstractSensorFactory.AbstractSensorFactory._abc_negative_cache_version	libsensorPy.abstractclass.abstractSensorFactory.AbstractSensorFactory-class.php#_abc_negative_cache_version
libsensorPy.abstractclass.abstractSensorFactory.AbstractSensorFactory._abc_registry	libsensorPy.abstractclass.abstractSensorFactory.AbstractSensorFactory-class.php#_abc_registry
libsensorPy.concretefactory.lightSensorFactory.LightSensorFactory.createEvent	libsensorPy.concretefactory.lightSensorFactory.LightSensorFactory-class.php#createEvent
libsensorPy.concretefactory.magnetometerSensorFactory.MagnetometerSensorFactory	libsensorPy.concretefactory.magnetometerSensorFactory.MagnetometerSensorFactory-class.php
libsensorPy.abstractclass.abstractSensorFactory.AbstractSensorFactory.__metaclass__	abc.ABCMeta-class.php
libsensorPy.abstractclass.abstractSensorFactory.AbstractSensorFactory._abc_negative_cache	libsensorPy.abstractclass.abstractSensorFactory.AbstractSensorFactory-class.php#_abc_negative_cache
libsensorPy.concretefactory.magnetometerSensorFactory.MagnetometerSensorFactory.createSensor	libsensorPy.concretefactory.magnetometerSensorFactory.MagnetometerSensorFactory-class.php#createSensor
libsensorPy.concretefactory.magnetometerSensorFactory.MagnetometerSensorFactory.__init__	libsensorPy.concretefactory.magnetometerSensorFactory.MagnetometerSensorFactory-class.php#__init__
libsensorPy.abstractclass.abstractSensorFactory.AbstractSensorFactory._abc_cache	libsensorPy.abstractclass.abstractSensorFactory.AbstractSensorFactory-class.php#_abc_cache
libsensorPy.abstractclass.abstractSensorFactory.AbstractSensorFactory.__abstractmethods__	libsensorPy.abstractclass.abstractSensorFactory.AbstractSensorFactory-class.php#__abstractmethods__
libsensorPy.abstractclass.abstractSensorFactory.AbstractSensorFactory._abc_negative_cache_version	libsensorPy.abstractclass.abstractSensorFactory.AbstractSensorFactory-class.php#_abc_negative_cache_version
libsensorPy.abstractclass.abstractSensorFactory.AbstractSensorFactory._abc_registry	libsensorPy.abstractclass.abstractSensorFactory.AbstractSensorFactory-class.php#_abc_registry
libsensorPy.concretefactory.magnetometerSensorFactory.MagnetometerSensorFactory.createEvent	libsensorPy.concretefactory.magnetometerSensorFactory.MagnetometerSensorFactory-class.php#createEvent
libsensorPy.concretefactory.motionSensorFactory.MotionSensorFactory	libsensorPy.concretefactory.motionSensorFactory.MotionSensorFactory-class.php
libsensorPy.abstractclass.abstractSensorFactory.AbstractSensorFactory.__metaclass__	abc.ABCMeta-class.php
libsensorPy.abstractclass.abstractSensorFactory.AbstractSensorFactory._abc_negative_cache	libsensorPy.abstractclass.abstractSensorFactory.AbstractSensorFactory-class.php#_abc_negative_cache
libsensorPy.concretefactory.motionSensorFactory.MotionSensorFactory.createSensor	libsensorPy.concretefactory.motionSensorFactory.MotionSensorFactory-class.php#createSensor
libsensorPy.concretefactory.motionSensorFactory.MotionSensorFactory.__init__	libsensorPy.concretefactory.motionSensorFactory.MotionSensorFactory-class.php#__init__
libsensorPy.abstractclass.abstractSensorFactory.AbstractSensorFactory._abc_cache	libsensorPy.abstractclass.abstractSensorFactory.AbstractSensorFactory-class.php#_abc_cache
libsensorPy.abstractclass.abstractSensorFactory.AbstractSensorFactory.__abstractmethods__	libsensorPy.abstractclass.abstractSensorFactory.AbstractSensorFactory-class.php#__abstractmethods__
libsensorPy.abstractclass.abstractSensorFactory.AbstractSensorFactory._abc_negative_cache_version	libsensorPy.abstractclass.abstractSensorFactory.AbstractSensorFactory-class.php#_abc_negative_cache_version
libsensorPy.abstractclass.abstractSensorFactory.AbstractSensorFactory._abc_registry	libsensorPy.abstractclass.abstractSensorFactory.AbstractSensorFactory-class.php#_abc_registry
libsensorPy.concretefactory.motionSensorFactory.MotionSensorFactory.createEvent	libsensorPy.concretefactory.motionSensorFactory.MotionSensorFactory-class.php#createEvent
libsensorPy.concretefactory.pressureSensorFactory.PressureSensorFactory	libsensorPy.concretefactory.pressureSensorFactory.PressureSensorFactory-class.php
libsensorPy.abstractclass.abstractSensorFactory.AbstractSensorFactory.__metaclass__	abc.ABCMeta-class.php
libsensorPy.abstractclass.abstractSensorFactory.AbstractSensorFactory._abc_negative_cache	libsensorPy.abstractclass.abstractSensorFactory.AbstractSensorFactory-class.php#_abc_negative_cache
libsensorPy.concretefactory.pressureSensorFactory.PressureSensorFactory.createSensor	libsensorPy.concretefactory.pressureSensorFactory.PressureSensorFactory-class.php#createSensor
libsensorPy.concretefactory.pressureSensorFactory.PressureSensorFactory.__init__	libsensorPy.concretefactory.pressureSensorFactory.PressureSensorFactory-class.php#__init__
libsensorPy.abstractclass.abstractSensorFactory.AbstractSensorFactory._abc_cache	libsensorPy.abstractclass.abstractSensorFactory.AbstractSensorFactory-class.php#_abc_cache
libsensorPy.abstractclass.abstractSensorFactory.AbstractSensorFactory.__abstractmethods__	libsensorPy.abstractclass.abstractSensorFactory.AbstractSensorFactory-class.php#__abstractmethods__
libsensorPy.abstractclass.abstractSensorFactory.AbstractSensorFactory._abc_negative_cache_version	libsensorPy.abstractclass.abstractSensorFactory.AbstractSensorFactory-class.php#_abc_negative_cache_version
libsensorPy.abstractclass.abstractSensorFactory.AbstractSensorFactory._abc_registry	libsensorPy.abstractclass.abstractSensorFactory.AbstractSensorFactory-class.php#_abc_registry
libsensorPy.concretefactory.pressureSensorFactory.PressureSensorFactory.createEvent	libsensorPy.concretefactory.pressureSensorFactory.PressureSensorFactory-class.php#createEvent
libsensorPy.concretefactory.stepperMotorActuatorFactory.StepperMotorActuatorFactory	libsensorPy.concretefactory.stepperMotorActuatorFactory.StepperMotorActuatorFactory-class.php
libsensorPy.abstractclass.abstractActuatorFactory.AbstractActuatorFactory.__metaclass__	abc.ABCMeta-class.php
libsensorPy.abstractclass.abstractActuatorFactory.AbstractActuatorFactory._abc_negative_cache	libsensorPy.abstractclass.abstractActuatorFactory.AbstractActuatorFactory-class.php#_abc_negative_cache
libsensorPy.concretefactory.stepperMotorActuatorFactory.StepperMotorActuatorFactory.__init__	libsensorPy.concretefactory.stepperMotorActuatorFactory.StepperMotorActuatorFactory-class.php#__init__
libsensorPy.abstractclass.abstractActuatorFactory.AbstractActuatorFactory._abc_cache	libsensorPy.abstractclass.abstractActuatorFactory.AbstractActuatorFactory-class.php#_abc_cache
libsensorPy.abstractclass.abstractActuatorFactory.AbstractActuatorFactory.__abstractmethods__	libsensorPy.abstractclass.abstractActuatorFactory.AbstractActuatorFactory-class.php#__abstractmethods__
libsensorPy.concretefactory.stepperMotorActuatorFactory.StepperMotorActuatorFactory.createActuator	libsensorPy.concretefactory.stepperMotorActuatorFactory.StepperMotorActuatorFactory-class.php#createActuator
libsensorPy.abstractclass.abstractActuatorFactory.AbstractActuatorFactory._abc_negative_cache_version	libsensorPy.abstractclass.abstractActuatorFactory.AbstractActuatorFactory-class.php#_abc_negative_cache_version
libsensorPy.abstractclass.abstractActuatorFactory.AbstractActuatorFactory._abc_registry	libsensorPy.abstractclass.abstractActuatorFactory.AbstractActuatorFactory-class.php#_abc_registry
libsensorPy.concretefactory.stepperMotorActuatorFactory.StepperMotorActuatorFactory.createEvent	libsensorPy.concretefactory.stepperMotorActuatorFactory.StepperMotorActuatorFactory-class.php#createEvent
libsensorPy.concretefactory.temperatureSensorFactory.TemperatureSensorFactory	libsensorPy.concretefactory.temperatureSensorFactory.TemperatureSensorFactory-class.php
libsensorPy.abstractclass.abstractSensorFactory.AbstractSensorFactory.__metaclass__	abc.ABCMeta-class.php
libsensorPy.abstractclass.abstractSensorFactory.AbstractSensorFactory._abc_negative_cache	libsensorPy.abstractclass.abstractSensorFactory.AbstractSensorFactory-class.php#_abc_negative_cache
libsensorPy.concretefactory.temperatureSensorFactory.TemperatureSensorFactory.createSensor	libsensorPy.concretefactory.temperatureSensorFactory.TemperatureSensorFactory-class.php#createSensor
libsensorPy.concretefactory.temperatureSensorFactory.TemperatureSensorFactory.__init__	libsensorPy.concretefactory.temperatureSensorFactory.TemperatureSensorFactory-class.php#__init__
libsensorPy.abstractclass.abstractSensorFactory.AbstractSensorFactory._abc_cache	libsensorPy.abstractclass.abstractSensorFactory.AbstractSensorFactory-class.php#_abc_cache
libsensorPy.abstractclass.abstractSensorFactory.AbstractSensorFactory.__abstractmethods__	libsensorPy.abstractclass.abstractSensorFactory.AbstractSensorFactory-class.php#__abstractmethods__
libsensorPy.abstractclass.abstractSensorFactory.AbstractSensorFactory._abc_negative_cache_version	libsensorPy.abstractclass.abstractSensorFactory.AbstractSensorFactory-class.php#_abc_negative_cache_version
libsensorPy.abstractclass.abstractSensorFactory.AbstractSensorFactory._abc_registry	libsensorPy.abstractclass.abstractSensorFactory.AbstractSensorFactory-class.php#_abc_registry
libsensorPy.concretefactory.temperatureSensorFactory.TemperatureSensorFactory.createEvent	libsensorPy.concretefactory.temperatureSensorFactory.TemperatureSensorFactory-class.php#createEvent
libsensorPy.concretefactory.ultrasonicSensorFactory.UltrasonicSensorFactory	libsensorPy.concretefactory.ultrasonicSensorFactory.UltrasonicSensorFactory-class.php
libsensorPy.abstractclass.abstractSensorFactory.AbstractSensorFactory.__metaclass__	abc.ABCMeta-class.php
libsensorPy.abstractclass.abstractSensorFactory.AbstractSensorFactory._abc_negative_cache	libsensorPy.abstractclass.abstractSensorFactory.AbstractSensorFactory-class.php#_abc_negative_cache
libsensorPy.concretefactory.ultrasonicSensorFactory.UltrasonicSensorFactory.createSensor	libsensorPy.concretefactory.ultrasonicSensorFactory.UltrasonicSensorFactory-class.php#createSensor
libsensorPy.concretefactory.ultrasonicSensorFactory.UltrasonicSensorFactory.__init__	libsensorPy.concretefactory.ultrasonicSensorFactory.UltrasonicSensorFactory-class.php#__init__
libsensorPy.abstractclass.abstractSensorFactory.AbstractSensorFactory._abc_cache	libsensorPy.abstractclass.abstractSensorFactory.AbstractSensorFactory-class.php#_abc_cache
libsensorPy.abstractclass.abstractSensorFactory.AbstractSensorFactory.__abstractmethods__	libsensorPy.abstractclass.abstractSensorFactory.AbstractSensorFactory-class.php#__abstractmethods__
libsensorPy.abstractclass.abstractSensorFactory.AbstractSensorFactory._abc_negative_cache_version	libsensorPy.abstractclass.abstractSensorFactory.AbstractSensorFactory-class.php#_abc_negative_cache_version
libsensorPy.abstractclass.abstractSensorFactory.AbstractSensorFactory._abc_registry	libsensorPy.abstractclass.abstractSensorFactory.AbstractSensorFactory-class.php#_abc_registry
libsensorPy.concretefactory.ultrasonicSensorFactory.UltrasonicSensorFactory.createEvent	libsensorPy.concretefactory.ultrasonicSensorFactory.UltrasonicSensorFactory-class.php#createEvent
libsensorPy.concreteobserver.currentConditionDisplay.CurrentConditionDisplay	libsensorPy.concreteobserver.currentConditionDisplay.CurrentConditionDisplay-class.php
libsensorPy.abstractclass.eventObserver.EventObserver.__metaclass__	abc.ABCMeta-class.php
libsensorPy.abstractclass.eventObserver.EventObserver._abc_negative_cache	libsensorPy.abstractclass.eventObserver.EventObserver-class.php#_abc_negative_cache
libsensorPy.abstractclass.eventObserver.EventObserver.remove_event	libsensorPy.abstractclass.eventObserver.EventObserver-class.php#remove_event
libsensorPy.concreteobserver.currentConditionDisplay.CurrentConditionDisplay.__init__	libsensorPy.concreteobserver.currentConditionDisplay.CurrentConditionDisplay-class.php#__init__
libsensorPy.abstractclass.eventObserver.EventObserver._abc_cache	libsensorPy.abstractclass.eventObserver.EventObserver-class.php#_abc_cache
libsensorPy.abstractclass.eventObserver.EventObserver.register_event	libsensorPy.abstractclass.eventObserver.EventObserver-class.php#register_event
libsensorPy.abstractclass.eventObserver.EventObserver.__abstractmethods__	libsensorPy.abstractclass.eventObserver.EventObserver-class.php#__abstractmethods__
libsensorPy.concreteobserver.currentConditionDisplay.CurrentConditionDisplay.update	libsensorPy.concreteobserver.currentConditionDisplay.CurrentConditionDisplay-class.php#update
libsensorPy.abstractclass.eventObserver.EventObserver._abc_negative_cache_version	libsensorPy.abstractclass.eventObserver.EventObserver-class.php#_abc_negative_cache_version
libsensorPy.abstractclass.eventObserver.EventObserver._abc_registry	libsensorPy.abstractclass.eventObserver.EventObserver-class.php#_abc_registry
libsensorPy.concreteobserver.currentConditionDisplay.CurrentConditionDisplay.display	libsensorPy.concreteobserver.currentConditionDisplay.CurrentConditionDisplay-class.php#display
libsensorPy.concretesensor.adxl345.ADXL345	libsensorPy.concretesensor.adxl345.ADXL345-class.php
libsensorPy.concretesensor.adxl345.ADXL345.__enableMeasurement	libsensorPy.concretesensor.adxl345.ADXL345-class.php#__enableMeasurement
libsensorPy.concretesensor.adxl345.ADXL345.BW_RATE_50HZ	libsensorPy.concretesensor.adxl345.ADXL345-class.php#BW_RATE_50HZ
libsensorPy.concretesensor.adxl345.ADXL345.BW_RATE_200HZ	libsensorPy.concretesensor.adxl345.ADXL345-class.php#BW_RATE_200HZ
libsensorPy.concretesensor.adxl345.ADXL345.BW_RATE_25HZ	libsensorPy.concretesensor.adxl345.ADXL345-class.php#BW_RATE_25HZ
libsensorPy.concretesensor.adxl345.ADXL345.BW_RATE	libsensorPy.concretesensor.adxl345.ADXL345-class.php#BW_RATE
libsensorPy.abstractclass.accelerometerSensor.AccelerometerSensor.__metaclass__	libsensorPy.abstractclass.accelerometerSensor.AccelerometerSensor-class.php#__metaclass__
libsensorPy.concretesensor.adxl345.ADXL345.getAxes	libsensorPy.concretesensor.adxl345.ADXL345-class.php#getAxes
libsensorPy.concretesensor.adxl345.ADXL345.__init__	libsensorPy.concretesensor.adxl345.ADXL345-class.php#__init__
libsensorPy.concretesensor.adxl345.ADXL345.RANGE_4G	libsensorPy.concretesensor.adxl345.ADXL345-class.php#RANGE_4G
libsensorPy.concretesensor.adxl345.ADXL345.BW_RATE_100HZ	libsensorPy.concretesensor.adxl345.ADXL345-class.php#BW_RATE_100HZ
libsensorPy.concretesensor.adxl345.ADXL345.BW_RATE_800HZ	libsensorPy.concretesensor.adxl345.ADXL345-class.php#BW_RATE_800HZ
libsensorPy.concretesensor.adxl345.ADXL345.RANGE_8G	libsensorPy.concretesensor.adxl345.ADXL345-class.php#RANGE_8G
libsensorPy.concretesensor.adxl345.ADXL345.RANGE_16G	libsensorPy.concretesensor.adxl345.ADXL345-class.php#RANGE_16G
libsensorPy.concretesensor.adxl345.ADXL345.EARTH_GRAVITY_MS2	libsensorPy.concretesensor.adxl345.ADXL345-class.php#EARTH_GRAVITY_MS2
libsensorPy.concretesensor.adxl345.ADXL345.MEASURE	libsensorPy.concretesensor.adxl345.ADXL345-class.php#MEASURE
libsensorPy.concretesensor.adxl345.ADXL345.AXES_DATA	libsensorPy.concretesensor.adxl345.ADXL345-class.php#AXES_DATA
libsensorPy.concretesensor.adxl345.ADXL345.BW_RATE_400HZ	libsensorPy.concretesensor.adxl345.ADXL345-class.php#BW_RATE_400HZ
libsensorPy.concretesensor.adxl345.ADXL345.BW_RATE_1600HZ	libsensorPy.concretesensor.adxl345.ADXL345-class.php#BW_RATE_1600HZ
libsensorPy.abstractclass.sensor.Sensor.__del__	libsensorPy.abstractclass.sensor.Sensor-class.php#__del__
libsensorPy.concretesensor.adxl345.ADXL345.address	libsensorPy.concretesensor.adxl345.ADXL345-class.php#address
libsensorPy.concretesensor.adxl345.ADXL345.changeSetup	libsensorPy.concretesensor.adxl345.ADXL345-class.php#changeSetup
libsensorPy.concretesensor.adxl345.ADXL345.POWER_CTL	libsensorPy.concretesensor.adxl345.ADXL345-class.php#POWER_CTL
libsensorPy.concretesensor.adxl345.ADXL345.RANGE_2G	libsensorPy.concretesensor.adxl345.ADXL345-class.php#RANGE_2G
libsensorPy.concretesensor.adxl345.ADXL345.SCALE_MULTIPLIER	libsensorPy.concretesensor.adxl345.ADXL345-class.php#SCALE_MULTIPLIER
libsensorPy.concretesensor.adxl345.ADXL345.setup	libsensorPy.concretesensor.adxl345.ADXL345-class.php#setup
libsensorPy.concretesensor.adxl345.ADXL345.DATA_FORMAT	libsensorPy.concretesensor.adxl345.ADXL345-class.php#DATA_FORMAT
libsensorPy.concretesensor.adxl345.ADXL345.setSensitivity	libsensorPy.concretesensor.adxl345.ADXL345-class.php#setSensitivity
libsensorPy.abstractclass.accelerometerSensor.AccelerometerSensor.getAxesInMS2	libsensorPy.abstractclass.accelerometerSensor.AccelerometerSensor-class.php#getAxesInMS2
libsensorPy.concretesensor.adxl345.ADXL345.__setBandwidthRate	libsensorPy.concretesensor.adxl345.ADXL345-class.php#__setBandwidthRate
libsensorPy.concretesensor.bmp085Altitude.BMP085Altitude	libsensorPy.concretesensor.bmp085Altitude.BMP085Altitude-class.php
libsensorPy.concretesensor.bmp085Altitude.BMP085Altitude.__READPRESSURECMD	libsensorPy.concretesensor.bmp085Altitude.BMP085Altitude-class.php#__READPRESSURECMD
libsensorPy.concretesensor.bmp085Altitude.BMP085Altitude.__CAL_AC2	libsensorPy.concretesensor.bmp085Altitude.BMP085Altitude-class.php#__CAL_AC2
libsensorPy.concretesensor.bmp085Altitude.BMP085Altitude.__CAL_AC3	libsensorPy.concretesensor.bmp085Altitude.BMP085Altitude-class.php#__CAL_AC3
libsensorPy.concretesensor.bmp085Altitude.BMP085Altitude.__CAL_AC1	libsensorPy.concretesensor.bmp085Altitude.BMP085Altitude-class.php#__CAL_AC1
libsensorPy.concretesensor.bmp085Altitude.BMP085Altitude.__CAL_AC6	libsensorPy.concretesensor.bmp085Altitude.BMP085Altitude-class.php#__CAL_AC6
libsensorPy.concretesensor.bmp085Altitude.BMP085Altitude.__TEMPDATA	libsensorPy.concretesensor.bmp085Altitude.BMP085Altitude-class.php#__TEMPDATA
libsensorPy.concretesensor.bmp085Altitude.BMP085Altitude.__CAL_AC5	libsensorPy.concretesensor.bmp085Altitude.BMP085Altitude-class.php#__CAL_AC5
libsensorPy.abstractclass.altitudeSensor.AltitudeSensor.getAltitudeInCm	libsensorPy.abstractclass.altitudeSensor.AltitudeSensor-class.php#getAltitudeInCm
libsensorPy.concretesensor.bmp085Altitude.BMP085Altitude.__cal_B2	libsensorPy.concretesensor.bmp085Altitude.BMP085Altitude-class.php#__cal_B2
libsensorPy.concretesensor.bmp085Altitude.BMP085Altitude.__cal_B1	libsensorPy.concretesensor.bmp085Altitude.BMP085Altitude-class.php#__cal_B1
libsensorPy.concretesensor.bmp085Altitude.BMP085Altitude.__STANDARD	libsensorPy.concretesensor.bmp085Altitude.BMP085Altitude-class.php#__STANDARD
libsensorPy.concretesensor.bmp085Altitude.BMP085Altitude.__ULTRAHIGHRES	libsensorPy.concretesensor.bmp085Altitude.BMP085Altitude-class.php#__ULTRAHIGHRES
libsensorPy.abstractclass.altitudeSensor.AltitudeSensor.__metaclass__	libsensorPy.abstractclass.altitudeSensor.AltitudeSensor-class.php#__metaclass__
libsensorPy.abstractclass.altitudeSensor.AltitudeSensor._SEA_LEVEL_PRESSURE	libsensorPy.abstractclass.altitudeSensor.AltitudeSensor-class.php#_SEA_LEVEL_PRESSURE
libsensorPy.concretesensor.bmp085Altitude.BMP085Altitude.__init__	libsensorPy.concretesensor.bmp085Altitude.BMP085Altitude-class.php#__init__
libsensorPy.concretesensor.bmp085Altitude.BMP085Altitude.__CONTROL	libsensorPy.concretesensor.bmp085Altitude.BMP085Altitude-class.php#__CONTROL
libsensorPy.concretesensor.bmp085Altitude.BMP085Altitude.__ULTRALOWPOWER	libsensorPy.concretesensor.bmp085Altitude.BMP085Altitude-class.php#__ULTRALOWPOWER
libsensorPy.concretesensor.bmp085Altitude.BMP085Altitude.__readRawPressure	libsensorPy.concretesensor.bmp085Altitude.BMP085Altitude-class.php#__readRawPressure
libsensorPy.concretesensor.bmp085Altitude.BMP085Altitude.__HIGHRES	libsensorPy.concretesensor.bmp085Altitude.BMP085Altitude-class.php#__HIGHRES
libsensorPy.concretesensor.bmp085Altitude.BMP085Altitude.__cal_MD	libsensorPy.concretesensor.bmp085Altitude.BMP085Altitude-class.php#__cal_MD
libsensorPy.concretesensor.bmp085Altitude.BMP085Altitude.__cal_MB	libsensorPy.concretesensor.bmp085Altitude.BMP085Altitude-class.php#__cal_MB
libsensorPy.concretesensor.bmp085Altitude.BMP085Altitude.__cal_MC	libsensorPy.concretesensor.bmp085Altitude.BMP085Altitude-class.php#__cal_MC
libsensorPy.concretesensor.bmp085Altitude.BMP085Altitude.__readRawTemp	libsensorPy.concretesensor.bmp085Altitude.BMP085Altitude-class.php#__readRawTemp
libsensorPy.concretesensor.bmp085Altitude.BMP085Altitude.__READTEMPCMD	libsensorPy.concretesensor.bmp085Altitude.BMP085Altitude-class.php#__READTEMPCMD
libsensorPy.abstractclass.sensor.Sensor.__del__	libsensorPy.abstractclass.sensor.Sensor-class.php#__del__
libsensorPy.concretesensor.bmp085Altitude.BMP085Altitude.getAltitude	libsensorPy.concretesensor.bmp085Altitude.BMP085Altitude-class.php#getAltitude
libsensorPy.concretesensor.bmp085Altitude.BMP085Altitude.__CAL_MD	libsensorPy.concretesensor.bmp085Altitude.BMP085Altitude-class.php#__CAL_MD
libsensorPy.concretesensor.bmp085Altitude.BMP085Altitude.__readCalibrationData	libsensorPy.concretesensor.bmp085Altitude.BMP085Altitude-class.php#__readCalibrationData
libsensorPy.concretesensor.bmp085Altitude.BMP085Altitude.__CAL_MB	libsensorPy.concretesensor.bmp085Altitude.BMP085Altitude-class.php#__CAL_MB
libsensorPy.concretesensor.bmp085Altitude.BMP085Altitude.__CAL_AC4	libsensorPy.concretesensor.bmp085Altitude.BMP085Altitude-class.php#__CAL_AC4
libsensorPy.concretesensor.bmp085Altitude.BMP085Altitude.changeSetup	libsensorPy.concretesensor.bmp085Altitude.BMP085Altitude-class.php#changeSetup
libsensorPy.concretesensor.bmp085Altitude.BMP085Altitude.__readPressure	libsensorPy.concretesensor.bmp085Altitude.BMP085Altitude-class.php#__readPressure
libsensorPy.concretesensor.bmp085Altitude.BMP085Altitude.__cal_AC2	libsensorPy.concretesensor.bmp085Altitude.BMP085Altitude-class.php#__cal_AC2
libsensorPy.concretesensor.bmp085Altitude.BMP085Altitude.__cal_AC3	libsensorPy.concretesensor.bmp085Altitude.BMP085Altitude-class.php#__cal_AC3
libsensorPy.concretesensor.bmp085Altitude.BMP085Altitude.setup	libsensorPy.concretesensor.bmp085Altitude.BMP085Altitude-class.php#setup
libsensorPy.concretesensor.bmp085Altitude.BMP085Altitude.__cal_AC1	libsensorPy.concretesensor.bmp085Altitude.BMP085Altitude-class.php#__cal_AC1
libsensorPy.concretesensor.bmp085Altitude.BMP085Altitude.__cal_AC6	libsensorPy.concretesensor.bmp085Altitude.BMP085Altitude-class.php#__cal_AC6
libsensorPy.concretesensor.bmp085Altitude.BMP085Altitude.__cal_AC4	libsensorPy.concretesensor.bmp085Altitude.BMP085Altitude-class.php#__cal_AC4
libsensorPy.concretesensor.bmp085Altitude.BMP085Altitude.__cal_AC5	libsensorPy.concretesensor.bmp085Altitude.BMP085Altitude-class.php#__cal_AC5
libsensorPy.concretesensor.bmp085Altitude.BMP085Altitude.__CAL_B2	libsensorPy.concretesensor.bmp085Altitude.BMP085Altitude-class.php#__CAL_B2
libsensorPy.concretesensor.bmp085Altitude.BMP085Altitude.__CAL_B1	libsensorPy.concretesensor.bmp085Altitude.BMP085Altitude-class.php#__CAL_B1
libsensorPy.concretesensor.bmp085Altitude.BMP085Altitude.__PRESSUREDATA	libsensorPy.concretesensor.bmp085Altitude.BMP085Altitude-class.php#__PRESSUREDATA
libsensorPy.concretesensor.bmp085Altitude.BMP085Altitude.__CAL_MC	libsensorPy.concretesensor.bmp085Altitude.BMP085Altitude-class.php#__CAL_MC
libsensorPy.concretesensor.bmp085Pressure.BMP085Pressure	libsensorPy.concretesensor.bmp085Pressure.BMP085Pressure-class.php
libsensorPy.abstractclass.pressureSensor.PressureSensor.getPressureInNm2	libsensorPy.abstractclass.pressureSensor.PressureSensor-class.php#getPressureInNm2
libsensorPy.concretesensor.bmp085Pressure.BMP085Pressure.__READPRESSURECMD	libsensorPy.concretesensor.bmp085Pressure.BMP085Pressure-class.php#__READPRESSURECMD
libsensorPy.concretesensor.bmp085Pressure.BMP085Pressure.__CAL_AC2	libsensorPy.concretesensor.bmp085Pressure.BMP085Pressure-class.php#__CAL_AC2
libsensorPy.concretesensor.bmp085Pressure.BMP085Pressure.__CAL_AC3	libsensorPy.concretesensor.bmp085Pressure.BMP085Pressure-class.php#__CAL_AC3
libsensorPy.concretesensor.bmp085Pressure.BMP085Pressure.__CAL_AC1	libsensorPy.concretesensor.bmp085Pressure.BMP085Pressure-class.php#__CAL_AC1
libsensorPy.concretesensor.bmp085Pressure.BMP085Pressure.__CAL_AC6	libsensorPy.concretesensor.bmp085Pressure.BMP085Pressure-class.php#__CAL_AC6
libsensorPy.concretesensor.bmp085Pressure.BMP085Pressure.__TEMPDATA	libsensorPy.concretesensor.bmp085Pressure.BMP085Pressure-class.php#__TEMPDATA
libsensorPy.concretesensor.bmp085Pressure.BMP085Pressure.__CAL_AC5	libsensorPy.concretesensor.bmp085Pressure.BMP085Pressure-class.php#__CAL_AC5
libsensorPy.concretesensor.bmp085Pressure.BMP085Pressure.__cal_B2	libsensorPy.concretesensor.bmp085Pressure.BMP085Pressure-class.php#__cal_B2
libsensorPy.concretesensor.bmp085Pressure.BMP085Pressure.__cal_B1	libsensorPy.concretesensor.bmp085Pressure.BMP085Pressure-class.php#__cal_B1
libsensorPy.concretesensor.bmp085Pressure.BMP085Pressure.__STANDARD	libsensorPy.concretesensor.bmp085Pressure.BMP085Pressure-class.php#__STANDARD
libsensorPy.concretesensor.bmp085Pressure.BMP085Pressure.__ULTRAHIGHRES	libsensorPy.concretesensor.bmp085Pressure.BMP085Pressure-class.php#__ULTRAHIGHRES
libsensorPy.abstractclass.pressureSensor.PressureSensor.__metaclass__	libsensorPy.abstractclass.pressureSensor.PressureSensor-class.php#__metaclass__
libsensorPy.concretesensor.bmp085Pressure.BMP085Pressure.__init__	libsensorPy.concretesensor.bmp085Pressure.BMP085Pressure-class.php#__init__
libsensorPy.concretesensor.bmp085Pressure.BMP085Pressure.__CONTROL	libsensorPy.concretesensor.bmp085Pressure.BMP085Pressure-class.php#__CONTROL
libsensorPy.abstractclass.pressureSensor.PressureSensor.getPressureInPsi	libsensorPy.abstractclass.pressureSensor.PressureSensor-class.php#getPressureInPsi
libsensorPy.concretesensor.bmp085Pressure.BMP085Pressure.__ULTRALOWPOWER	libsensorPy.concretesensor.bmp085Pressure.BMP085Pressure-class.php#__ULTRALOWPOWER
libsensorPy.abstractclass.pressureSensor.PressureSensor.getPressureInBar	libsensorPy.abstractclass.pressureSensor.PressureSensor-class.php#getPressureInBar
libsensorPy.concretesensor.bmp085Pressure.BMP085Pressure.__readRawPressure	libsensorPy.concretesensor.bmp085Pressure.BMP085Pressure-class.php#__readRawPressure
libsensorPy.concretesensor.bmp085Pressure.BMP085Pressure.__HIGHRES	libsensorPy.concretesensor.bmp085Pressure.BMP085Pressure-class.php#__HIGHRES
libsensorPy.concretesensor.bmp085Pressure.BMP085Pressure.__cal_MD	libsensorPy.concretesensor.bmp085Pressure.BMP085Pressure-class.php#__cal_MD
libsensorPy.concretesensor.bmp085Pressure.BMP085Pressure.__cal_MB	libsensorPy.concretesensor.bmp085Pressure.BMP085Pressure-class.php#__cal_MB
libsensorPy.concretesensor.bmp085Pressure.BMP085Pressure.__cal_MC	libsensorPy.concretesensor.bmp085Pressure.BMP085Pressure-class.php#__cal_MC
libsensorPy.concretesensor.bmp085Pressure.BMP085Pressure.__readRawTemp	libsensorPy.concretesensor.bmp085Pressure.BMP085Pressure-class.php#__readRawTemp
libsensorPy.concretesensor.bmp085Pressure.BMP085Pressure.__READTEMPCMD	libsensorPy.concretesensor.bmp085Pressure.BMP085Pressure-class.php#__READTEMPCMD
libsensorPy.abstractclass.sensor.Sensor.__del__	libsensorPy.abstractclass.sensor.Sensor-class.php#__del__
libsensorPy.concretesensor.bmp085Pressure.BMP085Pressure.getPressure	libsensorPy.concretesensor.bmp085Pressure.BMP085Pressure-class.php#getPressure
libsensorPy.concretesensor.bmp085Pressure.BMP085Pressure.__CAL_MD	libsensorPy.concretesensor.bmp085Pressure.BMP085Pressure-class.php#__CAL_MD
libsensorPy.concretesensor.bmp085Pressure.BMP085Pressure.__readCalibrationData	libsensorPy.concretesensor.bmp085Pressure.BMP085Pressure-class.php#__readCalibrationData
libsensorPy.concretesensor.bmp085Pressure.BMP085Pressure.__CAL_MB	libsensorPy.concretesensor.bmp085Pressure.BMP085Pressure-class.php#__CAL_MB
libsensorPy.concretesensor.bmp085Pressure.BMP085Pressure.__CAL_AC4	libsensorPy.concretesensor.bmp085Pressure.BMP085Pressure-class.php#__CAL_AC4
libsensorPy.abstractclass.pressureSensor.PressureSensor.getPressureInMmhg	libsensorPy.abstractclass.pressureSensor.PressureSensor-class.php#getPressureInMmhg
libsensorPy.concretesensor.bmp085Pressure.BMP085Pressure.changeSetup	libsensorPy.concretesensor.bmp085Pressure.BMP085Pressure-class.php#changeSetup
libsensorPy.concretesensor.bmp085Pressure.BMP085Pressure.__cal_AC2	libsensorPy.concretesensor.bmp085Pressure.BMP085Pressure-class.php#__cal_AC2
libsensorPy.concretesensor.bmp085Pressure.BMP085Pressure.__cal_AC3	libsensorPy.concretesensor.bmp085Pressure.BMP085Pressure-class.php#__cal_AC3
libsensorPy.concretesensor.bmp085Pressure.BMP085Pressure.setup	libsensorPy.concretesensor.bmp085Pressure.BMP085Pressure-class.php#setup
libsensorPy.concretesensor.bmp085Pressure.BMP085Pressure.__cal_AC1	libsensorPy.concretesensor.bmp085Pressure.BMP085Pressure-class.php#__cal_AC1
libsensorPy.concretesensor.bmp085Pressure.BMP085Pressure.__cal_AC6	libsensorPy.concretesensor.bmp085Pressure.BMP085Pressure-class.php#__cal_AC6
libsensorPy.concretesensor.bmp085Pressure.BMP085Pressure.__cal_AC4	libsensorPy.concretesensor.bmp085Pressure.BMP085Pressure-class.php#__cal_AC4
libsensorPy.concretesensor.bmp085Pressure.BMP085Pressure.__cal_AC5	libsensorPy.concretesensor.bmp085Pressure.BMP085Pressure-class.php#__cal_AC5
libsensorPy.concretesensor.bmp085Pressure.BMP085Pressure.__CAL_B2	libsensorPy.concretesensor.bmp085Pressure.BMP085Pressure-class.php#__CAL_B2
libsensorPy.concretesensor.bmp085Pressure.BMP085Pressure.__CAL_B1	libsensorPy.concretesensor.bmp085Pressure.BMP085Pressure-class.php#__CAL_B1
libsensorPy.concretesensor.bmp085Pressure.BMP085Pressure.__PRESSUREDATA	libsensorPy.concretesensor.bmp085Pressure.BMP085Pressure-class.php#__PRESSUREDATA
libsensorPy.concretesensor.bmp085Pressure.BMP085Pressure.__CAL_MC	libsensorPy.concretesensor.bmp085Pressure.BMP085Pressure-class.php#__CAL_MC
libsensorPy.concretesensor.bmp085Temperature.BMP085Temperature	libsensorPy.concretesensor.bmp085Temperature.BMP085Temperature-class.php
libsensorPy.concretesensor.bmp085Temperature.BMP085Temperature.__READPRESSURECMD	libsensorPy.concretesensor.bmp085Temperature.BMP085Temperature-class.php#__READPRESSURECMD
libsensorPy.concretesensor.bmp085Temperature.BMP085Temperature.__CAL_AC2	libsensorPy.concretesensor.bmp085Temperature.BMP085Temperature-class.php#__CAL_AC2
libsensorPy.concretesensor.bmp085Temperature.BMP085Temperature.__CAL_AC3	libsensorPy.concretesensor.bmp085Temperature.BMP085Temperature-class.php#__CAL_AC3
libsensorPy.concretesensor.bmp085Temperature.BMP085Temperature.__CAL_AC1	libsensorPy.concretesensor.bmp085Temperature.BMP085Temperature-class.php#__CAL_AC1
libsensorPy.concretesensor.bmp085Temperature.BMP085Temperature.__CAL_AC6	libsensorPy.concretesensor.bmp085Temperature.BMP085Temperature-class.php#__CAL_AC6
libsensorPy.concretesensor.bmp085Temperature.BMP085Temperature.__TEMPDATA	libsensorPy.concretesensor.bmp085Temperature.BMP085Temperature-class.php#__TEMPDATA
libsensorPy.concretesensor.bmp085Temperature.BMP085Temperature.__CAL_AC5	libsensorPy.concretesensor.bmp085Temperature.BMP085Temperature-class.php#__CAL_AC5
libsensorPy.concretesensor.bmp085Temperature.BMP085Temperature.__cal_B2	libsensorPy.concretesensor.bmp085Temperature.BMP085Temperature-class.php#__cal_B2
libsensorPy.concretesensor.bmp085Temperature.BMP085Temperature.__cal_B1	libsensorPy.concretesensor.bmp085Temperature.BMP085Temperature-class.php#__cal_B1
libsensorPy.concretesensor.bmp085Temperature.BMP085Temperature.__STANDARD	libsensorPy.concretesensor.bmp085Temperature.BMP085Temperature-class.php#__STANDARD
libsensorPy.concretesensor.bmp085Temperature.BMP085Temperature.__ULTRAHIGHRES	libsensorPy.concretesensor.bmp085Temperature.BMP085Temperature-class.php#__ULTRAHIGHRES
libsensorPy.abstractclass.temperatureSensor.TemperatureSensor.__metaclass__	libsensorPy.abstractclass.temperatureSensor.TemperatureSensor-class.php#__metaclass__
libsensorPy.concretesensor.bmp085Temperature.BMP085Temperature.__init__	libsensorPy.concretesensor.bmp085Temperature.BMP085Temperature-class.php#__init__
libsensorPy.concretesensor.bmp085Temperature.BMP085Temperature.__CONTROL	libsensorPy.concretesensor.bmp085Temperature.BMP085Temperature-class.php#__CONTROL
libsensorPy.concretesensor.bmp085Temperature.BMP085Temperature.__ULTRALOWPOWER	libsensorPy.concretesensor.bmp085Temperature.BMP085Temperature-class.php#__ULTRALOWPOWER
libsensorPy.concretesensor.bmp085Temperature.BMP085Temperature.getTemperature	libsensorPy.concretesensor.bmp085Temperature.BMP085Temperature-class.php#getTemperature
libsensorPy.concretesensor.bmp085Temperature.BMP085Temperature.__HIGHRES	libsensorPy.concretesensor.bmp085Temperature.BMP085Temperature-class.php#__HIGHRES
libsensorPy.concretesensor.bmp085Temperature.BMP085Temperature.__cal_MD	libsensorPy.concretesensor.bmp085Temperature.BMP085Temperature-class.php#__cal_MD
libsensorPy.concretesensor.bmp085Temperature.BMP085Temperature.__cal_MB	libsensorPy.concretesensor.bmp085Temperature.BMP085Temperature-class.php#__cal_MB
libsensorPy.concretesensor.bmp085Temperature.BMP085Temperature.__cal_MC	libsensorPy.concretesensor.bmp085Temperature.BMP085Temperature-class.php#__cal_MC
libsensorPy.concretesensor.bmp085Temperature.BMP085Temperature.__readRawTemp	libsensorPy.concretesensor.bmp085Temperature.BMP085Temperature-class.php#__readRawTemp
libsensorPy.concretesensor.bmp085Temperature.BMP085Temperature.__READTEMPCMD	libsensorPy.concretesensor.bmp085Temperature.BMP085Temperature-class.php#__READTEMPCMD
libsensorPy.abstractclass.temperatureSensor.TemperatureSensor.getTemperatureInFahrenheit	libsensorPy.abstractclass.temperatureSensor.TemperatureSensor-class.php#getTemperatureInFahrenheit
libsensorPy.abstractclass.sensor.Sensor.__del__	libsensorPy.abstractclass.sensor.Sensor-class.php#__del__
libsensorPy.concretesensor.bmp085Temperature.BMP085Temperature.__CAL_MD	libsensorPy.concretesensor.bmp085Temperature.BMP085Temperature-class.php#__CAL_MD
libsensorPy.concretesensor.bmp085Temperature.BMP085Temperature.__readCalibrationData	libsensorPy.concretesensor.bmp085Temperature.BMP085Temperature-class.php#__readCalibrationData
libsensorPy.concretesensor.bmp085Temperature.BMP085Temperature.__CAL_MB	libsensorPy.concretesensor.bmp085Temperature.BMP085Temperature-class.php#__CAL_MB
libsensorPy.concretesensor.bmp085Temperature.BMP085Temperature.__CAL_AC4	libsensorPy.concretesensor.bmp085Temperature.BMP085Temperature-class.php#__CAL_AC4
libsensorPy.concretesensor.bmp085Temperature.BMP085Temperature.changeSetup	libsensorPy.concretesensor.bmp085Temperature.BMP085Temperature-class.php#changeSetup
libsensorPy.abstractclass.temperatureSensor.TemperatureSensor.getTemperatureInKelvin	libsensorPy.abstractclass.temperatureSensor.TemperatureSensor-class.php#getTemperatureInKelvin
libsensorPy.concretesensor.bmp085Temperature.BMP085Temperature.__cal_AC2	libsensorPy.concretesensor.bmp085Temperature.BMP085Temperature-class.php#__cal_AC2
libsensorPy.concretesensor.bmp085Temperature.BMP085Temperature.__cal_AC3	libsensorPy.concretesensor.bmp085Temperature.BMP085Temperature-class.php#__cal_AC3
libsensorPy.concretesensor.bmp085Temperature.BMP085Temperature.setup	libsensorPy.concretesensor.bmp085Temperature.BMP085Temperature-class.php#setup
libsensorPy.concretesensor.bmp085Temperature.BMP085Temperature.__cal_AC1	libsensorPy.concretesensor.bmp085Temperature.BMP085Temperature-class.php#__cal_AC1
libsensorPy.concretesensor.bmp085Temperature.BMP085Temperature.__cal_AC6	libsensorPy.concretesensor.bmp085Temperature.BMP085Temperature-class.php#__cal_AC6
libsensorPy.concretesensor.bmp085Temperature.BMP085Temperature.__cal_AC4	libsensorPy.concretesensor.bmp085Temperature.BMP085Temperature-class.php#__cal_AC4
libsensorPy.concretesensor.bmp085Temperature.BMP085Temperature.__cal_AC5	libsensorPy.concretesensor.bmp085Temperature.BMP085Temperature-class.php#__cal_AC5
libsensorPy.concretesensor.bmp085Temperature.BMP085Temperature.__CAL_B2	libsensorPy.concretesensor.bmp085Temperature.BMP085Temperature-class.php#__CAL_B2
libsensorPy.concretesensor.bmp085Temperature.BMP085Temperature.__CAL_B1	libsensorPy.concretesensor.bmp085Temperature.BMP085Temperature-class.php#__CAL_B1
libsensorPy.abstractclass.temperatureSensor.TemperatureSensor._bin2dec	libsensorPy.abstractclass.temperatureSensor.TemperatureSensor-class.php#_bin2dec
libsensorPy.concretesensor.bmp085Temperature.BMP085Temperature.__PRESSUREDATA	libsensorPy.concretesensor.bmp085Temperature.BMP085Temperature-class.php#__PRESSUREDATA
libsensorPy.concretesensor.bmp085Temperature.BMP085Temperature.__CAL_MC	libsensorPy.concretesensor.bmp085Temperature.BMP085Temperature-class.php#__CAL_MC
libsensorPy.concretesensor.dht11Humidity.DHT11Humidity	libsensorPy.concretesensor.dht11Humidity.DHT11Humidity-class.php
libsensorPy.abstractclass.humiditySensor.HumiditySensor.__metaclass__	libsensorPy.abstractclass.humiditySensor.HumiditySensor-class.php#__metaclass__
libsensorPy.concretesensor.dht11Humidity.DHT11Humidity.__checkValidData	libsensorPy.concretesensor.dht11Humidity.DHT11Humidity-class.php#__checkValidData
libsensorPy.concretesensor.dht11Humidity.DHT11Humidity.__init__	libsensorPy.concretesensor.dht11Humidity.DHT11Humidity-class.php#__init__
libsensorPy.abstractclass.sensor.Sensor.__del__	libsensorPy.abstractclass.sensor.Sensor-class.php#__del__
libsensorPy.concretesensor.dht11Humidity.DHT11Humidity.getHumidity	libsensorPy.concretesensor.dht11Humidity.DHT11Humidity-class.php#getHumidity
libsensorPy.concretesensor.dht11Humidity.DHT11Humidity.__getValidData	libsensorPy.concretesensor.dht11Humidity.DHT11Humidity-class.php#__getValidData
libsensorPy.concretesensor.dht11Humidity.DHT11Humidity.changeSetup	libsensorPy.concretesensor.dht11Humidity.DHT11Humidity-class.php#changeSetup
libsensorPy.concretesensor.dht11Humidity.DHT11Humidity.__readData	libsensorPy.concretesensor.dht11Humidity.DHT11Humidity-class.php#__readData
libsensorPy.concretesensor.dht11Humidity.DHT11Humidity.setup	libsensorPy.concretesensor.dht11Humidity.DHT11Humidity-class.php#setup
libsensorPy.abstractclass.humiditySensor.HumiditySensor._bin2dec	libsensorPy.abstractclass.humiditySensor.HumiditySensor-class.php#_bin2dec
libsensorPy.concretesensor.dht11Temperature.DHT11Temperature	libsensorPy.concretesensor.dht11Temperature.DHT11Temperature-class.php
libsensorPy.abstractclass.temperatureSensor.TemperatureSensor.__metaclass__	libsensorPy.abstractclass.temperatureSensor.TemperatureSensor-class.php#__metaclass__
libsensorPy.concretesensor.dht11Temperature.DHT11Temperature.__readData	libsensorPy.concretesensor.dht11Temperature.DHT11Temperature-class.php#__readData
libsensorPy.concretesensor.dht11Temperature.DHT11Temperature.__init__	libsensorPy.concretesensor.dht11Temperature.DHT11Temperature-class.php#__init__
libsensorPy.concretesensor.dht11Temperature.DHT11Temperature.getTemperature	libsensorPy.concretesensor.dht11Temperature.DHT11Temperature-class.php#getTemperature
libsensorPy.abstractclass.temperatureSensor.TemperatureSensor.getTemperatureInFahrenheit	libsensorPy.abstractclass.temperatureSensor.TemperatureSensor-class.php#getTemperatureInFahrenheit
libsensorPy.abstractclass.sensor.Sensor.__del__	libsensorPy.abstractclass.sensor.Sensor-class.php#__del__
libsensorPy.concretesensor.dht11Temperature.DHT11Temperature.__getValidData	libsensorPy.concretesensor.dht11Temperature.DHT11Temperature-class.php#__getValidData
libsensorPy.concretesensor.dht11Temperature.DHT11Temperature.changeSetup	libsensorPy.concretesensor.dht11Temperature.DHT11Temperature-class.php#changeSetup
libsensorPy.abstractclass.temperatureSensor.TemperatureSensor.getTemperatureInKelvin	libsensorPy.abstractclass.temperatureSensor.TemperatureSensor-class.php#getTemperatureInKelvin
libsensorPy.concretesensor.dht11Temperature.DHT11Temperature.__checkValidData	libsensorPy.concretesensor.dht11Temperature.DHT11Temperature-class.php#__checkValidData
libsensorPy.concretesensor.dht11Temperature.DHT11Temperature.setup	libsensorPy.concretesensor.dht11Temperature.DHT11Temperature-class.php#setup
libsensorPy.abstractclass.temperatureSensor.TemperatureSensor._bin2dec	libsensorPy.abstractclass.temperatureSensor.TemperatureSensor-class.php#_bin2dec
libsensorPy.concretesensor.dht22Humidity.DHT22Humidity	libsensorPy.concretesensor.dht22Humidity.DHT22Humidity-class.php
libsensorPy.abstractclass.humiditySensor.HumiditySensor.__metaclass__	libsensorPy.abstractclass.humiditySensor.HumiditySensor-class.php#__metaclass__
libsensorPy.concretesensor.dht22Humidity.DHT22Humidity.__cb	libsensorPy.concretesensor.dht22Humidity.DHT22Humidity-class.php#__cb
libsensorPy.concretesensor.dht22Humidity.DHT22Humidity.__trigger	libsensorPy.concretesensor.dht22Humidity.DHT22Humidity-class.php#__trigger
libsensorPy.concretesensor.dht22Humidity.DHT22Humidity.__cancel	libsensorPy.concretesensor.dht22Humidity.DHT22Humidity-class.php#__cancel
libsensorPy.concretesensor.dht22Humidity.DHT22Humidity.__init__	libsensorPy.concretesensor.dht22Humidity.DHT22Humidity-class.php#__init__
libsensorPy.abstractclass.sensor.Sensor.__del__	libsensorPy.abstractclass.sensor.Sensor-class.php#__del__
libsensorPy.concretesensor.dht22Humidity.DHT22Humidity.getHumidity	libsensorPy.concretesensor.dht22Humidity.DHT22Humidity-class.php#getHumidity
libsensorPy.concretesensor.dht22Humidity.DHT22Humidity.changeSetup	libsensorPy.concretesensor.dht22Humidity.DHT22Humidity-class.php#changeSetup
libsensorPy.concretesensor.dht22Humidity.DHT22Humidity.setup	libsensorPy.concretesensor.dht22Humidity.DHT22Humidity-class.php#setup
libsensorPy.abstractclass.humiditySensor.HumiditySensor._bin2dec	libsensorPy.abstractclass.humiditySensor.HumiditySensor-class.php#_bin2dec
libsensorPy.concretesensor.dht22Temperature.DHT22Temperature	libsensorPy.concretesensor.dht22Temperature.DHT22Temperature-class.php
libsensorPy.abstractclass.temperatureSensor.TemperatureSensor.__metaclass__	libsensorPy.abstractclass.temperatureSensor.TemperatureSensor-class.php#__metaclass__
libsensorPy.concretesensor.dht22Temperature.DHT22Temperature.__cb	libsensorPy.concretesensor.dht22Temperature.DHT22Temperature-class.php#__cb
libsensorPy.concretesensor.dht22Temperature.DHT22Temperature.__trigger	libsensorPy.concretesensor.dht22Temperature.DHT22Temperature-class.php#__trigger
libsensorPy.concretesensor.dht22Temperature.DHT22Temperature.__cancel	libsensorPy.concretesensor.dht22Temperature.DHT22Temperature-class.php#__cancel
libsensorPy.concretesensor.dht22Temperature.DHT22Temperature.__init__	libsensorPy.concretesensor.dht22Temperature.DHT22Temperature-class.php#__init__
libsensorPy.concretesensor.dht22Temperature.DHT22Temperature.getTemperature	libsensorPy.concretesensor.dht22Temperature.DHT22Temperature-class.php#getTemperature
libsensorPy.abstractclass.temperatureSensor.TemperatureSensor.getTemperatureInFahrenheit	libsensorPy.abstractclass.temperatureSensor.TemperatureSensor-class.php#getTemperatureInFahrenheit
libsensorPy.abstractclass.sensor.Sensor.__del__	libsensorPy.abstractclass.sensor.Sensor-class.php#__del__
libsensorPy.concretesensor.dht22Temperature.DHT22Temperature.changeSetup	libsensorPy.concretesensor.dht22Temperature.DHT22Temperature-class.php#changeSetup
libsensorPy.abstractclass.temperatureSensor.TemperatureSensor.getTemperatureInKelvin	libsensorPy.abstractclass.temperatureSensor.TemperatureSensor-class.php#getTemperatureInKelvin
libsensorPy.concretesensor.dht22Temperature.DHT22Temperature.setup	libsensorPy.concretesensor.dht22Temperature.DHT22Temperature-class.php#setup
libsensorPy.abstractclass.temperatureSensor.TemperatureSensor._bin2dec	libsensorPy.abstractclass.temperatureSensor.TemperatureSensor-class.php#_bin2dec
libsensorPy.concretesensor.hmc5883l.HMC5883L	libsensorPy.concretesensor.hmc5883l.HMC5883L-class.php
libsensorPy.concretesensor.hmc5883l.HMC5883L.CRA_BIAS_BIT	libsensorPy.concretesensor.hmc5883l.HMC5883L-class.php#CRA_BIAS_BIT
libsensorPy.concretesensor.hmc5883l.HMC5883L.AVERAGING_4	libsensorPy.concretesensor.hmc5883l.HMC5883L-class.php#AVERAGING_4
libsensorPy.concretesensor.hmc5883l.HMC5883L.AVERAGING_2	libsensorPy.concretesensor.hmc5883l.HMC5883L-class.php#AVERAGING_2
libsensorPy.concretesensor.hmc5883l.HMC5883L.CRA_RATE_BIT	libsensorPy.concretesensor.hmc5883l.HMC5883L-class.php#CRA_RATE_BIT
libsensorPy.concretesensor.hmc5883l.HMC5883L.AVERAGING_1	libsensorPy.concretesensor.hmc5883l.HMC5883L-class.php#AVERAGING_1
libsensorPy.concretesensor.hmc5883l.HMC5883L.GAIN_220	libsensorPy.concretesensor.hmc5883l.HMC5883L-class.php#GAIN_220
libsensorPy.concretesensor.hmc5883l.HMC5883L.GAIN_390	libsensorPy.concretesensor.hmc5883l.HMC5883L-class.php#GAIN_390
libsensorPy.concretesensor.hmc5883l.HMC5883L.RA_DATAZ_H	libsensorPy.concretesensor.hmc5883l.HMC5883L-class.php#RA_DATAZ_H
libsensorPy.concretesensor.hmc5883l.HMC5883L.MODE_CONTINUOUS	libsensorPy.concretesensor.hmc5883l.HMC5883L-class.php#MODE_CONTINUOUS
libsensorPy.concretesensor.hmc5883l.HMC5883L.AVERAGING_8	libsensorPy.concretesensor.hmc5883l.HMC5883L-class.php#AVERAGING_8
libsensorPy.concretesensor.hmc5883l.HMC5883L.RA_DATAZ_L	libsensorPy.concretesensor.hmc5883l.HMC5883L-class.php#RA_DATAZ_L
libsensorPy.concretesensor.hmc5883l.HMC5883L.getMagnetic	libsensorPy.concretesensor.hmc5883l.HMC5883L-class.php#getMagnetic
libsensorPy.concretesensor.hmc5883l.HMC5883L.STATUS_LOCK_BIT	libsensorPy.concretesensor.hmc5883l.HMC5883L-class.php#STATUS_LOCK_BIT
libsensorPy.abstractclass.magnetometerSensor.MagnetometerSensor.__metaclass__	libsensorPy.abstractclass.magnetometerSensor.MagnetometerSensor-class.php#__metaclass__
libsensorPy.concretesensor.hmc5883l.HMC5883L.MODE_SINGLE	libsensorPy.concretesensor.hmc5883l.HMC5883L-class.php#MODE_SINGLE
libsensorPy.concretesensor.hmc5883l.HMC5883L.RA_CONFIG_B	libsensorPy.concretesensor.hmc5883l.HMC5883L-class.php#RA_CONFIG_B
libsensorPy.concretesensor.hmc5883l.HMC5883L.CRA_AVERAGE_LENGTH	libsensorPy.concretesensor.hmc5883l.HMC5883L-class.php#CRA_AVERAGE_LENGTH
libsensorPy.concretesensor.hmc5883l.HMC5883L.__init__	libsensorPy.concretesensor.hmc5883l.HMC5883L-class.php#__init__
libsensorPy.concretesensor.hmc5883l.HMC5883L.RA_CONFIG_A	libsensorPy.concretesensor.hmc5883l.HMC5883L-class.php#RA_CONFIG_A
libsensorPy.concretesensor.hmc5883l.HMC5883L.GAIN_1370	libsensorPy.concretesensor.hmc5883l.HMC5883L-class.php#GAIN_1370
libsensorPy.concretesensor.hmc5883l.HMC5883L.RATE_3	libsensorPy.concretesensor.hmc5883l.HMC5883L-class.php#RATE_3
libsensorPy.concretesensor.hmc5883l.HMC5883L.RATE_30	libsensorPy.concretesensor.hmc5883l.HMC5883L-class.php#RATE_30
libsensorPy.concretesensor.hmc5883l.HMC5883L.GAIN_1090	libsensorPy.concretesensor.hmc5883l.HMC5883L-class.php#GAIN_1090
libsensorPy.concretesensor.hmc5883l.HMC5883L.STATUS_READY_BIT	libsensorPy.concretesensor.hmc5883l.HMC5883L-class.php#STATUS_READY_BIT
libsensorPy.concretesensor.hmc5883l.HMC5883L.RA_DATAY_L	libsensorPy.concretesensor.hmc5883l.HMC5883L-class.php#RA_DATAY_L
libsensorPy.concretesensor.hmc5883l.HMC5883L.GAIN_820	libsensorPy.concretesensor.hmc5883l.HMC5883L-class.php#GAIN_820
libsensorPy.concretesensor.hmc5883l.HMC5883L.BIAS_NORMAL	libsensorPy.concretesensor.hmc5883l.HMC5883L-class.php#BIAS_NORMAL
libsensorPy.concretesensor.hmc5883l.HMC5883L.RA_DATAY_H	libsensorPy.concretesensor.hmc5883l.HMC5883L-class.php#RA_DATAY_H
libsensorPy.concretesensor.hmc5883l.HMC5883L.RATE_7P5	libsensorPy.concretesensor.hmc5883l.HMC5883L-class.php#RATE_7P5
libsensorPy.concretesensor.hmc5883l.HMC5883L.__setMode	libsensorPy.concretesensor.hmc5883l.HMC5883L-class.php#__setMode
libsensorPy.concretesensor.hmc5883l.HMC5883L.RA_DATAX_L	libsensorPy.concretesensor.hmc5883l.HMC5883L-class.php#RA_DATAX_L
libsensorPy.concretesensor.hmc5883l.HMC5883L.CRA_BIAS_LENGTH	libsensorPy.concretesensor.hmc5883l.HMC5883L-class.php#CRA_BIAS_LENGTH
libsensorPy.concretesensor.hmc5883l.HMC5883L.DEFAULT_ADDRESS	libsensorPy.concretesensor.hmc5883l.HMC5883L-class.php#DEFAULT_ADDRESS
libsensorPy.concretesensor.hmc5883l.HMC5883L.RATE_0P75	libsensorPy.concretesensor.hmc5883l.HMC5883L-class.php#RATE_0P75
libsensorPy.concretesensor.hmc5883l.HMC5883L.BIAS_POSITIVE	libsensorPy.concretesensor.hmc5883l.HMC5883L-class.php#BIAS_POSITIVE
libsensorPy.concretesensor.hmc5883l.HMC5883L.RA_DATAX_H	libsensorPy.concretesensor.hmc5883l.HMC5883L-class.php#RA_DATAX_H
libsensorPy.concretesensor.hmc5883l.HMC5883L.RATE_15	libsensorPy.concretesensor.hmc5883l.HMC5883L-class.php#RATE_15
libsensorPy.concretesensor.hmc5883l.HMC5883L.RA_ID_C	libsensorPy.concretesensor.hmc5883l.HMC5883L-class.php#RA_ID_C
libsensorPy.concretesensor.hmc5883l.HMC5883L.MODE_IDLE	libsensorPy.concretesensor.hmc5883l.HMC5883L-class.php#MODE_IDLE
libsensorPy.abstractclass.sensor.Sensor.__del__	libsensorPy.abstractclass.sensor.Sensor-class.php#__del__
libsensorPy.concretesensor.hmc5883l.HMC5883L.ADDRESS	libsensorPy.concretesensor.hmc5883l.HMC5883L-class.php#ADDRESS
libsensorPy.concretesensor.hmc5883l.HMC5883L.RATE_75	libsensorPy.concretesensor.hmc5883l.HMC5883L-class.php#RATE_75
libsensorPy.concretesensor.hmc5883l.HMC5883L.GAIN_440	libsensorPy.concretesensor.hmc5883l.HMC5883L-class.php#GAIN_440
libsensorPy.concretesensor.hmc5883l.HMC5883L.GAIN_660	libsensorPy.concretesensor.hmc5883l.HMC5883L-class.php#GAIN_660
libsensorPy.concretesensor.hmc5883l.HMC5883L.CRB_GAIN_LENGTH	libsensorPy.concretesensor.hmc5883l.HMC5883L-class.php#CRB_GAIN_LENGTH
libsensorPy.concretesensor.hmc5883l.HMC5883L.RATE_1P5	libsensorPy.concretesensor.hmc5883l.HMC5883L-class.php#RATE_1P5
libsensorPy.concretesensor.hmc5883l.HMC5883L.changeSetup	libsensorPy.concretesensor.hmc5883l.HMC5883L-class.php#changeSetup
libsensorPy.concretesensor.hmc5883l.HMC5883L.GAIN_330	libsensorPy.concretesensor.hmc5883l.HMC5883L-class.php#GAIN_330
libsensorPy.concretesensor.hmc5883l.HMC5883L.RA_MODE	libsensorPy.concretesensor.hmc5883l.HMC5883L-class.php#RA_MODE
libsensorPy.concretesensor.hmc5883l.HMC5883L.RA_ID_B	libsensorPy.concretesensor.hmc5883l.HMC5883L-class.php#RA_ID_B
libsensorPy.concretesensor.hmc5883l.HMC5883L.RA_ID_A	libsensorPy.concretesensor.hmc5883l.HMC5883L-class.php#RA_ID_A
libsensorPy.concretesensor.hmc5883l.HMC5883L.RA_STATUS	libsensorPy.concretesensor.hmc5883l.HMC5883L-class.php#RA_STATUS
libsensorPy.concretesensor.hmc5883l.HMC5883L.setup	libsensorPy.concretesensor.hmc5883l.HMC5883L-class.php#setup
libsensorPy.concretesensor.hmc5883l.HMC5883L.CRA_RATE_LENGTH	libsensorPy.concretesensor.hmc5883l.HMC5883L-class.php#CRA_RATE_LENGTH
libsensorPy.concretesensor.hmc5883l.HMC5883L.MODEREG_LENGTH	libsensorPy.concretesensor.hmc5883l.HMC5883L-class.php#MODEREG_LENGTH
libsensorPy.concretesensor.hmc5883l.HMC5883L.MODEREG_BIT	libsensorPy.concretesensor.hmc5883l.HMC5883L-class.php#MODEREG_BIT
libsensorPy.concretesensor.hmc5883l.HMC5883L.__setGain	libsensorPy.concretesensor.hmc5883l.HMC5883L-class.php#__setGain
libsensorPy.concretesensor.hmc5883l.HMC5883L.BIAS_NEGATIVE	libsensorPy.concretesensor.hmc5883l.HMC5883L-class.php#BIAS_NEGATIVE
libsensorPy.concretesensor.hmc5883l.HMC5883L.CRA_AVERAGE_BIT	libsensorPy.concretesensor.hmc5883l.HMC5883L-class.php#CRA_AVERAGE_BIT
libsensorPy.concretesensor.hmc5883l.HMC5883L.CRB_GAIN_BIT	libsensorPy.concretesensor.hmc5883l.HMC5883L-class.php#CRB_GAIN_BIT
libsensorPy.concretesensor.hysrf05.HYSRF05	libsensorPy.concretesensor.hysrf05.HYSRF05-class.php
libsensorPy.abstractclass.ultrasonicSensor.UltrasonicSensor.__metaclass__	libsensorPy.abstractclass.ultrasonicSensor.UltrasonicSensor-class.php#__metaclass__
libsensorPy.concretesensor.hysrf05.HYSRF05.distance_in_cm	libsensorPy.concretesensor.hysrf05.HYSRF05-class.php#distance_in_cm
libsensorPy.abstractclass.sensor.Sensor.__del__	libsensorPy.abstractclass.sensor.Sensor-class.php#__del__
libsensorPy.concretesensor.hysrf05.HYSRF05.changeSetup	libsensorPy.concretesensor.hysrf05.HYSRF05-class.php#changeSetup
libsensorPy.concretesensor.hysrf05.HYSRF05.setup	libsensorPy.concretesensor.hysrf05.HYSRF05-class.php#setup
libsensorPy.abstractclass.ultrasonicSensor.UltrasonicSensor.distance_in_inches	libsensorPy.abstractclass.ultrasonicSensor.UltrasonicSensor-class.php#distance_in_inches
libsensorPy.abstractclass.ultrasonicSensor.UltrasonicSensor._bin2dec	libsensorPy.abstractclass.ultrasonicSensor.UltrasonicSensor-class.php#_bin2dec
libsensorPy.concretesensor.hysrf05.HYSRF05.__init__	libsensorPy.concretesensor.hysrf05.HYSRF05-class.php#__init__
libsensorPy.concretesensor.lsm303dAccelerometer.LSM303DAccelerometer	libsensorPy.concretesensor.lsm303dAccelerometer.LSM303DAccelerometer-class.php
libsensorPy.concretesensor.lsm303dAccelerometer.LSM303DAccelerometer.__detect	libsensorPy.concretesensor.lsm303dAccelerometer.LSM303DAccelerometer-class.php#__detect
libsensorPy.abstractclass.accelerometerSensor.AccelerometerSensor.__metaclass__	libsensorPy.abstractclass.accelerometerSensor.AccelerometerSensor-class.php#__metaclass__
libsensorPy.concretesensor.lsm303dAccelerometer.LSM303DAccelerometer.ACC_X_LSB	libsensorPy.concretesensor.lsm303dAccelerometer.LSM303DAccelerometer-class.php#ACC_X_LSB
libsensorPy.concretesensor.lsm303dAccelerometer.LSM303DAccelerometer.MAG_X_LSB	libsensorPy.concretesensor.lsm303dAccelerometer.LSM303DAccelerometer-class.php#MAG_X_LSB
libsensorPy.concretesensor.lsm303dAccelerometer.LSM303DAccelerometer.ACC_Z_LSB	libsensorPy.concretesensor.lsm303dAccelerometer.LSM303DAccelerometer-class.php#ACC_Z_LSB
libsensorPy.concretesensor.lsm303dAccelerometer.LSM303DAccelerometer.__init__	libsensorPy.concretesensor.lsm303dAccelerometer.LSM303DAccelerometer-class.php#__init__
libsensorPy.concretesensor.lsm303dAccelerometer.LSM303DAccelerometer.ACC_X_MSB	libsensorPy.concretesensor.lsm303dAccelerometer.LSM303DAccelerometer-class.php#ACC_X_MSB
libsensorPy.concretesensor.lsm303dAccelerometer.LSM303DAccelerometer.getAxes	libsensorPy.concretesensor.lsm303dAccelerometer.LSM303DAccelerometer-class.php#getAxes
libsensorPy.concretesensor.lsm303dAccelerometer.LSM303DAccelerometer.MAG_X_MSB	libsensorPy.concretesensor.lsm303dAccelerometer.LSM303DAccelerometer-class.php#MAG_X_MSB
libsensorPy.concretesensor.lsm303dAccelerometer.LSM303DAccelerometer.LSM	libsensorPy.concretesensor.lsm303dAccelerometer.LSM303DAccelerometer-class.php#LSM
libsensorPy.concretesensor.lsm303dAccelerometer.LSM303DAccelerometer.MAG_Z_MSB	libsensorPy.concretesensor.lsm303dAccelerometer.LSM303DAccelerometer-class.php#MAG_Z_MSB
libsensorPy.abstractclass.accelerometerSensor.AccelerometerSensor.EARTH_GRAVITY_MS2	libsensorPy.abstractclass.accelerometerSensor.AccelerometerSensor-class.php#EARTH_GRAVITY_MS2
libsensorPy.concretesensor.lsm303dAccelerometer.LSM303DAccelerometer.__twos_comp_combine	libsensorPy.concretesensor.lsm303dAccelerometer.LSM303DAccelerometer-class.php#__twos_comp_combine
libsensorPy.concretesensor.lsm303dAccelerometer.LSM303DAccelerometer.LSM_WHOAMI	libsensorPy.concretesensor.lsm303dAccelerometer.LSM303DAccelerometer-class.php#LSM_WHOAMI
libsensorPy.abstractclass.accelerometerSensor.AccelerometerSensor.getAxesInMS2	libsensorPy.abstractclass.accelerometerSensor.AccelerometerSensor-class.php#getAxesInMS2
libsensorPy.concretesensor.lsm303dAccelerometer.LSM303DAccelerometer.MAG_Z_LSB	libsensorPy.concretesensor.lsm303dAccelerometer.LSM303DAccelerometer-class.php#MAG_Z_LSB
libsensorPy.concretesensor.lsm303dAccelerometer.LSM303DAccelerometer.MAG_Y_LSB	libsensorPy.concretesensor.lsm303dAccelerometer.LSM303DAccelerometer-class.php#MAG_Y_LSB
libsensorPy.abstractclass.sensor.Sensor.__del__	libsensorPy.abstractclass.sensor.Sensor-class.php#__del__
libsensorPy.concretesensor.lsm303dAccelerometer.LSM303DAccelerometer.__configure	libsensorPy.concretesensor.lsm303dAccelerometer.LSM303DAccelerometer-class.php#__configure
libsensorPy.concretesensor.lsm303dAccelerometer.LSM303DAccelerometer.MAG_Y_MSB	libsensorPy.concretesensor.lsm303dAccelerometer.LSM303DAccelerometer-class.php#MAG_Y_MSB
libsensorPy.concretesensor.lsm303dAccelerometer.LSM303DAccelerometer.changeSetup	libsensorPy.concretesensor.lsm303dAccelerometer.LSM303DAccelerometer-class.php#changeSetup
libsensorPy.concretesensor.lsm303dAccelerometer.LSM303DAccelerometer.ACC_Y_LSB	libsensorPy.concretesensor.lsm303dAccelerometer.LSM303DAccelerometer-class.php#ACC_Y_LSB
libsensorPy.concretesensor.lsm303dAccelerometer.LSM303DAccelerometer.TEMP_MSB	libsensorPy.concretesensor.lsm303dAccelerometer.LSM303DAccelerometer-class.php#TEMP_MSB
libsensorPy.concretesensor.lsm303dAccelerometer.LSM303DAccelerometer.setup	libsensorPy.concretesensor.lsm303dAccelerometer.LSM303DAccelerometer-class.php#setup
libsensorPy.concretesensor.lsm303dAccelerometer.LSM303DAccelerometer.CTRL_4	libsensorPy.concretesensor.lsm303dAccelerometer.LSM303DAccelerometer-class.php#CTRL_4
libsensorPy.concretesensor.lsm303dAccelerometer.LSM303DAccelerometer.CTRL_5	libsensorPy.concretesensor.lsm303dAccelerometer.LSM303DAccelerometer-class.php#CTRL_5
libsensorPy.concretesensor.lsm303dAccelerometer.LSM303DAccelerometer.CTRL_6	libsensorPy.concretesensor.lsm303dAccelerometer.LSM303DAccelerometer-class.php#CTRL_6
libsensorPy.concretesensor.lsm303dAccelerometer.LSM303DAccelerometer.CTRL_7	libsensorPy.concretesensor.lsm303dAccelerometer.LSM303DAccelerometer-class.php#CTRL_7
libsensorPy.concretesensor.lsm303dAccelerometer.LSM303DAccelerometer.CTRL_0	libsensorPy.concretesensor.lsm303dAccelerometer.LSM303DAccelerometer-class.php#CTRL_0
libsensorPy.concretesensor.lsm303dAccelerometer.LSM303DAccelerometer.CTRL_1	libsensorPy.concretesensor.lsm303dAccelerometer.LSM303DAccelerometer-class.php#CTRL_1
libsensorPy.concretesensor.lsm303dAccelerometer.LSM303DAccelerometer.CTRL_2	libsensorPy.concretesensor.lsm303dAccelerometer.LSM303DAccelerometer-class.php#CTRL_2
libsensorPy.concretesensor.lsm303dAccelerometer.LSM303DAccelerometer.CTRL_3	libsensorPy.concretesensor.lsm303dAccelerometer.LSM303DAccelerometer-class.php#CTRL_3
libsensorPy.concretesensor.lsm303dAccelerometer.LSM303DAccelerometer.TEMP_LSB	libsensorPy.concretesensor.lsm303dAccelerometer.LSM303DAccelerometer-class.php#TEMP_LSB
libsensorPy.concretesensor.lsm303dAccelerometer.LSM303DAccelerometer.ACC_Y_MSB	libsensorPy.concretesensor.lsm303dAccelerometer.LSM303DAccelerometer-class.php#ACC_Y_MSB
libsensorPy.concretesensor.lsm303dAccelerometer.LSM303DAccelerometer.ACC_Z_MSB	libsensorPy.concretesensor.lsm303dAccelerometer.LSM303DAccelerometer-class.php#ACC_Z_MSB
libsensorPy.concretesensor.lsm303dMagnetometer.LSM303DMagnetometer	libsensorPy.concretesensor.lsm303dMagnetometer.LSM303DMagnetometer-class.php
libsensorPy.concretesensor.lsm303dMagnetometer.LSM303DMagnetometer.__detect	libsensorPy.concretesensor.lsm303dMagnetometer.LSM303DMagnetometer-class.php#__detect
libsensorPy.abstractclass.magnetometerSensor.MagnetometerSensor.__metaclass__	libsensorPy.abstractclass.magnetometerSensor.MagnetometerSensor-class.php#__metaclass__
libsensorPy.concretesensor.lsm303dMagnetometer.LSM303DMagnetometer.ACC_X_LSB	libsensorPy.concretesensor.lsm303dMagnetometer.LSM303DMagnetometer-class.php#ACC_X_LSB
libsensorPy.concretesensor.lsm303dMagnetometer.LSM303DMagnetometer.MAG_X_LSB	libsensorPy.concretesensor.lsm303dMagnetometer.LSM303DMagnetometer-class.php#MAG_X_LSB
libsensorPy.concretesensor.lsm303dMagnetometer.LSM303DMagnetometer.ACC_Z_LSB	libsensorPy.concretesensor.lsm303dMagnetometer.LSM303DMagnetometer-class.php#ACC_Z_LSB
libsensorPy.concretesensor.lsm303dMagnetometer.LSM303DMagnetometer.__init__	libsensorPy.concretesensor.lsm303dMagnetometer.LSM303DMagnetometer-class.php#__init__
libsensorPy.concretesensor.lsm303dMagnetometer.LSM303DMagnetometer.ACC_X_MSB	libsensorPy.concretesensor.lsm303dMagnetometer.LSM303DMagnetometer-class.php#ACC_X_MSB
libsensorPy.concretesensor.lsm303dMagnetometer.LSM303DMagnetometer.MAG_X_MSB	libsensorPy.concretesensor.lsm303dMagnetometer.LSM303DMagnetometer-class.php#MAG_X_MSB
libsensorPy.concretesensor.lsm303dMagnetometer.LSM303DMagnetometer.LSM	libsensorPy.concretesensor.lsm303dMagnetometer.LSM303DMagnetometer-class.php#LSM
libsensorPy.concretesensor.lsm303dMagnetometer.LSM303DMagnetometer.MAG_Z_MSB	libsensorPy.concretesensor.lsm303dMagnetometer.LSM303DMagnetometer-class.php#MAG_Z_MSB
libsensorPy.concretesensor.lsm303dMagnetometer.LSM303DMagnetometer.__twos_comp_combine	libsensorPy.concretesensor.lsm303dMagnetometer.LSM303DMagnetometer-class.php#__twos_comp_combine
libsensorPy.concretesensor.lsm303dMagnetometer.LSM303DMagnetometer.getMagnetic	libsensorPy.concretesensor.lsm303dMagnetometer.LSM303DMagnetometer-class.php#getMagnetic
libsensorPy.concretesensor.lsm303dMagnetometer.LSM303DMagnetometer.LSM_WHOAMI	libsensorPy.concretesensor.lsm303dMagnetometer.LSM303DMagnetometer-class.php#LSM_WHOAMI
libsensorPy.concretesensor.lsm303dMagnetometer.LSM303DMagnetometer.MAG_Z_LSB	libsensorPy.concretesensor.lsm303dMagnetometer.LSM303DMagnetometer-class.php#MAG_Z_LSB
libsensorPy.concretesensor.lsm303dMagnetometer.LSM303DMagnetometer.MAG_Y_LSB	libsensorPy.concretesensor.lsm303dMagnetometer.LSM303DMagnetometer-class.php#MAG_Y_LSB
libsensorPy.abstractclass.sensor.Sensor.__del__	libsensorPy.abstractclass.sensor.Sensor-class.php#__del__
libsensorPy.concretesensor.lsm303dMagnetometer.LSM303DMagnetometer.__configure	libsensorPy.concretesensor.lsm303dMagnetometer.LSM303DMagnetometer-class.php#__configure
libsensorPy.concretesensor.lsm303dMagnetometer.LSM303DMagnetometer.MAG_Y_MSB	libsensorPy.concretesensor.lsm303dMagnetometer.LSM303DMagnetometer-class.php#MAG_Y_MSB
libsensorPy.concretesensor.lsm303dMagnetometer.LSM303DMagnetometer.changeSetup	libsensorPy.concretesensor.lsm303dMagnetometer.LSM303DMagnetometer-class.php#changeSetup
libsensorPy.concretesensor.lsm303dMagnetometer.LSM303DMagnetometer.ACC_Y_LSB	libsensorPy.concretesensor.lsm303dMagnetometer.LSM303DMagnetometer-class.php#ACC_Y_LSB
libsensorPy.concretesensor.lsm303dMagnetometer.LSM303DMagnetometer.TEMP_MSB	libsensorPy.concretesensor.lsm303dMagnetometer.LSM303DMagnetometer-class.php#TEMP_MSB
libsensorPy.concretesensor.lsm303dMagnetometer.LSM303DMagnetometer.setup	libsensorPy.concretesensor.lsm303dMagnetometer.LSM303DMagnetometer-class.php#setup
libsensorPy.concretesensor.lsm303dMagnetometer.LSM303DMagnetometer.CTRL_4	libsensorPy.concretesensor.lsm303dMagnetometer.LSM303DMagnetometer-class.php#CTRL_4
libsensorPy.concretesensor.lsm303dMagnetometer.LSM303DMagnetometer.CTRL_5	libsensorPy.concretesensor.lsm303dMagnetometer.LSM303DMagnetometer-class.php#CTRL_5
libsensorPy.concretesensor.lsm303dMagnetometer.LSM303DMagnetometer.CTRL_6	libsensorPy.concretesensor.lsm303dMagnetometer.LSM303DMagnetometer-class.php#CTRL_6
libsensorPy.concretesensor.lsm303dMagnetometer.LSM303DMagnetometer.CTRL_7	libsensorPy.concretesensor.lsm303dMagnetometer.LSM303DMagnetometer-class.php#CTRL_7
libsensorPy.concretesensor.lsm303dMagnetometer.LSM303DMagnetometer.CTRL_0	libsensorPy.concretesensor.lsm303dMagnetometer.LSM303DMagnetometer-class.php#CTRL_0
libsensorPy.concretesensor.lsm303dMagnetometer.LSM303DMagnetometer.CTRL_1	libsensorPy.concretesensor.lsm303dMagnetometer.LSM303DMagnetometer-class.php#CTRL_1
libsensorPy.concretesensor.lsm303dMagnetometer.LSM303DMagnetometer.CTRL_2	libsensorPy.concretesensor.lsm303dMagnetometer.LSM303DMagnetometer-class.php#CTRL_2
libsensorPy.concretesensor.lsm303dMagnetometer.LSM303DMagnetometer.CTRL_3	libsensorPy.concretesensor.lsm303dMagnetometer.LSM303DMagnetometer-class.php#CTRL_3
libsensorPy.concretesensor.lsm303dMagnetometer.LSM303DMagnetometer.TEMP_LSB	libsensorPy.concretesensor.lsm303dMagnetometer.LSM303DMagnetometer-class.php#TEMP_LSB
libsensorPy.concretesensor.lsm303dMagnetometer.LSM303DMagnetometer.ACC_Y_MSB	libsensorPy.concretesensor.lsm303dMagnetometer.LSM303DMagnetometer-class.php#ACC_Y_MSB
libsensorPy.concretesensor.lsm303dMagnetometer.LSM303DMagnetometer.ACC_Z_MSB	libsensorPy.concretesensor.lsm303dMagnetometer.LSM303DMagnetometer-class.php#ACC_Z_MSB
libsensorPy.concretesensor.parallaxPing.ParallaxPing	libsensorPy.concretesensor.parallaxPing.ParallaxPing-class.php
libsensorPy.abstractclass.ultrasonicSensor.UltrasonicSensor.__metaclass__	libsensorPy.abstractclass.ultrasonicSensor.UltrasonicSensor-class.php#__metaclass__
libsensorPy.concretesensor.parallaxPing.ParallaxPing.distance_in_cm	libsensorPy.concretesensor.parallaxPing.ParallaxPing-class.php#distance_in_cm
libsensorPy.abstractclass.sensor.Sensor.__del__	libsensorPy.abstractclass.sensor.Sensor-class.php#__del__
libsensorPy.concretesensor.parallaxPing.ParallaxPing.changeSetup	libsensorPy.concretesensor.parallaxPing.ParallaxPing-class.php#changeSetup
libsensorPy.concretesensor.parallaxPing.ParallaxPing.setup	libsensorPy.concretesensor.parallaxPing.ParallaxPing-class.php#setup
libsensorPy.abstractclass.ultrasonicSensor.UltrasonicSensor.distance_in_inches	libsensorPy.abstractclass.ultrasonicSensor.UltrasonicSensor-class.php#distance_in_inches
libsensorPy.abstractclass.ultrasonicSensor.UltrasonicSensor._bin2dec	libsensorPy.abstractclass.ultrasonicSensor.UltrasonicSensor-class.php#_bin2dec
libsensorPy.concretesensor.parallaxPing.ParallaxPing.__init__	libsensorPy.concretesensor.parallaxPing.ParallaxPing-class.php#__init__
libsensorPy.concretesensor.pir.PIR	libsensorPy.concretesensor.pir.PIR-class.php
libsensorPy.abstractclass.motionSensor.MotionSensor.__metaclass__	libsensorPy.abstractclass.motionSensor.MotionSensor-class.php#__metaclass__
libsensorPy.abstractclass.sensor.Sensor.__del__	libsensorPy.abstractclass.sensor.Sensor-class.php#__del__
libsensorPy.concretesensor.pir.PIR.setup	libsensorPy.concretesensor.pir.PIR-class.php#setup
libsensorPy.concretesensor.pir.PIR.isMotionDetected	libsensorPy.concretesensor.pir.PIR-class.php#isMotionDetected
libsensorPy.concretesensor.pir.PIR.changeSetup	libsensorPy.concretesensor.pir.PIR-class.php#changeSetup
libsensorPy.concretesensor.pir.PIR.__init__	libsensorPy.concretesensor.pir.PIR-class.php#__init__
libsensorPy.concretesensor.srf04.SRF04	libsensorPy.concretesensor.srf04.SRF04-class.php
libsensorPy.abstractclass.ultrasonicSensor.UltrasonicSensor.__metaclass__	libsensorPy.abstractclass.ultrasonicSensor.UltrasonicSensor-class.php#__metaclass__
libsensorPy.concretesensor.srf04.SRF04.distance_in_cm	libsensorPy.concretesensor.srf04.SRF04-class.php#distance_in_cm
libsensorPy.abstractclass.sensor.Sensor.__del__	libsensorPy.abstractclass.sensor.Sensor-class.php#__del__
libsensorPy.concretesensor.srf04.SRF04.changeSetup	libsensorPy.concretesensor.srf04.SRF04-class.php#changeSetup
libsensorPy.concretesensor.srf04.SRF04.setup	libsensorPy.concretesensor.srf04.SRF04-class.php#setup
libsensorPy.abstractclass.ultrasonicSensor.UltrasonicSensor.distance_in_inches	libsensorPy.abstractclass.ultrasonicSensor.UltrasonicSensor-class.php#distance_in_inches
libsensorPy.abstractclass.ultrasonicSensor.UltrasonicSensor._bin2dec	libsensorPy.abstractclass.ultrasonicSensor.UltrasonicSensor-class.php#_bin2dec
libsensorPy.concretesensor.srf04.SRF04.__init__	libsensorPy.concretesensor.srf04.SRF04-class.php#__init__
libsensorPy.concretesensor.srf05.SRF05	libsensorPy.concretesensor.srf05.SRF05-class.php
libsensorPy.abstractclass.ultrasonicSensor.UltrasonicSensor.__metaclass__	libsensorPy.abstractclass.ultrasonicSensor.UltrasonicSensor-class.php#__metaclass__
libsensorPy.concretesensor.srf05.SRF05.distance_in_cm	libsensorPy.concretesensor.srf05.SRF05-class.php#distance_in_cm
libsensorPy.abstractclass.sensor.Sensor.__del__	libsensorPy.abstractclass.sensor.Sensor-class.php#__del__
libsensorPy.concretesensor.srf05.SRF05.changeSetup	libsensorPy.concretesensor.srf05.SRF05-class.php#changeSetup
libsensorPy.concretesensor.srf05.SRF05.setup	libsensorPy.concretesensor.srf05.SRF05-class.php#setup
libsensorPy.abstractclass.ultrasonicSensor.UltrasonicSensor.distance_in_inches	libsensorPy.abstractclass.ultrasonicSensor.UltrasonicSensor-class.php#distance_in_inches
libsensorPy.abstractclass.ultrasonicSensor.UltrasonicSensor._bin2dec	libsensorPy.abstractclass.ultrasonicSensor.UltrasonicSensor-class.php#_bin2dec
libsensorPy.concretesensor.srf05.SRF05.__init__	libsensorPy.concretesensor.srf05.SRF05-class.php#__init__
libsensorPy.concretesensor.tcs34725.TCS34725	libsensorPy.concretesensor.tcs34725.TCS34725-class.php
libsensorPy.concretesensor.tcs34725.TCS34725.__PERS_3_CYCLE	libsensorPy.concretesensor.tcs34725.TCS34725-class.php#__PERS_3_CYCLE
libsensorPy.concretesensor.tcs34725.TCS34725.__CONFIG_WLONG	libsensorPy.concretesensor.tcs34725.TCS34725-class.php#__CONFIG_WLONG
libsensorPy.concretesensor.tcs34725.TCS34725.__PERS_20_CYCLE	libsensorPy.concretesensor.tcs34725.TCS34725-class.php#__PERS_20_CYCLE
libsensorPy.concretesensor.tcs34725.TCS34725.__CONTROL	libsensorPy.concretesensor.tcs34725.TCS34725-class.php#__CONTROL
libsensorPy.concretesensor.tcs34725.TCS34725.__ENABLE_AEN	libsensorPy.concretesensor.tcs34725.TCS34725-class.php#__ENABLE_AEN
libsensorPy.concretesensor.tcs34725.TCS34725.__GDATAH	libsensorPy.concretesensor.tcs34725.TCS34725-class.php#__GDATAH
libsensorPy.concretesensor.tcs34725.TCS34725.__INTEGRATIONTIME_2_4MS	libsensorPy.concretesensor.tcs34725.TCS34725-class.php#__INTEGRATIONTIME_2_4MS
libsensorPy.concretesensor.tcs34725.TCS34725.__GDATAL	libsensorPy.concretesensor.tcs34725.TCS34725-class.php#__GDATAL
libsensorPy.concretesensor.tcs34725.TCS34725.__PERS_5_CYCLE	libsensorPy.concretesensor.tcs34725.TCS34725-class.php#__PERS_5_CYCLE
libsensorPy.concretesensor.tcs34725.TCS34725.__PERS	libsensorPy.concretesensor.tcs34725.TCS34725-class.php#__PERS
libsensorPy.concretesensor.tcs34725.TCS34725.__ADDRESS	libsensorPy.concretesensor.tcs34725.TCS34725-class.php#__ADDRESS
libsensorPy.concretesensor.tcs34725.TCS34725.__BDATAL	libsensorPy.concretesensor.tcs34725.TCS34725-class.php#__BDATAL
libsensorPy.concretesensor.tcs34725.TCS34725.__GAIN_4X	libsensorPy.concretesensor.tcs34725.TCS34725-class.php#__GAIN_4X
libsensorPy.concretesensor.tcs34725.TCS34725.__PERS_2_CYCLE	libsensorPy.concretesensor.tcs34725.TCS34725-class.php#__PERS_2_CYCLE
libsensorPy.concretesensor.tcs34725.TCS34725.__STATUS_AVALID	libsensorPy.concretesensor.tcs34725.TCS34725-class.php#__STATUS_AVALID
libsensorPy.abstractclass.lightSensor.LightSensor.getLux	libsensorPy.abstractclass.lightSensor.LightSensor-class.php#getLux
libsensorPy.concretesensor.tcs34725.TCS34725.__WTIME	libsensorPy.concretesensor.tcs34725.TCS34725-class.php#__WTIME
libsensorPy.concretesensor.tcs34725.TCS34725.__ID	libsensorPy.concretesensor.tcs34725.TCS34725-class.php#__ID
libsensorPy.concretesensor.tcs34725.TCS34725.__PERS_25_CYCLE	libsensorPy.concretesensor.tcs34725.TCS34725-class.php#__PERS_25_CYCLE
libsensorPy.concretesensor.tcs34725.TCS34725.__PERS_NONE	libsensorPy.concretesensor.tcs34725.TCS34725-class.php#__PERS_NONE
libsensorPy.concretesensor.tcs34725.TCS34725.__PERS_40_CYCLE	libsensorPy.concretesensor.tcs34725.TCS34725-class.php#__PERS_40_CYCLE
libsensorPy.concretesensor.tcs34725.TCS34725.__PERS_50_CYCLE	libsensorPy.concretesensor.tcs34725.TCS34725-class.php#__PERS_50_CYCLE
libsensorPy.concretesensor.tcs34725.TCS34725.__getIntegrationTime	libsensorPy.concretesensor.tcs34725.TCS34725-class.php#__getIntegrationTime
libsensorPy.abstractclass.lightSensor.LightSensor.__metaclass__	libsensorPy.abstractclass.lightSensor.LightSensor-class.php#__metaclass__
libsensorPy.concretesensor.tcs34725.TCS34725.__AIHTL	libsensorPy.concretesensor.tcs34725.TCS34725-class.php#__AIHTL
libsensorPy.concretesensor.tcs34725.TCS34725.__ENABLE_PON	libsensorPy.concretesensor.tcs34725.TCS34725-class.php#__ENABLE_PON
libsensorPy.concretesensor.tcs34725.TCS34725.__AIHTH	libsensorPy.concretesensor.tcs34725.TCS34725-class.php#__AIHTH
libsensorPy.concretesensor.tcs34725.TCS34725.__INTEGRATIONTIME_700MS	libsensorPy.concretesensor.tcs34725.TCS34725-class.php#__INTEGRATIONTIME_700MS
libsensorPy.concretesensor.tcs34725.TCS34725.__PERS_1_CYCLE	libsensorPy.concretesensor.tcs34725.TCS34725-class.php#__PERS_1_CYCLE
libsensorPy.concretesensor.tcs34725.TCS34725.__WTIME_2_4MS	libsensorPy.concretesensor.tcs34725.TCS34725-class.php#__WTIME_2_4MS
libsensorPy.concretesensor.tcs34725.TCS34725.__INTEGRATIONTIME_154MS	libsensorPy.concretesensor.tcs34725.TCS34725-class.php#__INTEGRATIONTIME_154MS
libsensorPy.concretesensor.tcs34725.TCS34725.__INTEGRATIONTIME_101MS	libsensorPy.concretesensor.tcs34725.TCS34725-class.php#__INTEGRATIONTIME_101MS
libsensorPy.concretesensor.tcs34725.TCS34725.__ENABLE	libsensorPy.concretesensor.tcs34725.TCS34725-class.php#__ENABLE
libsensorPy.concretesensor.tcs34725.TCS34725.calculateLux	libsensorPy.concretesensor.tcs34725.TCS34725-class.php#calculateLux
libsensorPy.concretesensor.tcs34725.TCS34725.__GAIN_60X	libsensorPy.concretesensor.tcs34725.TCS34725-class.php#__GAIN_60X
libsensorPy.concretesensor.tcs34725.TCS34725.__PERS_35_CYCLE	libsensorPy.concretesensor.tcs34725.TCS34725-class.php#__PERS_35_CYCLE
libsensorPy.concretesensor.tcs34725.TCS34725.__ATIME	libsensorPy.concretesensor.tcs34725.TCS34725-class.php#__ATIME
libsensorPy.concretesensor.tcs34725.TCS34725.__GAIN_16X	libsensorPy.concretesensor.tcs34725.TCS34725-class.php#__GAIN_16X
libsensorPy.concretesensor.tcs34725.TCS34725.__STATUS	libsensorPy.concretesensor.tcs34725.TCS34725-class.php#__STATUS
libsensorPy.concretesensor.tcs34725.TCS34725.__setInterrupt	libsensorPy.concretesensor.tcs34725.TCS34725-class.php#__setInterrupt
libsensorPy.concretesensor.tcs34725.TCS34725.__CDATAL	libsensorPy.concretesensor.tcs34725.TCS34725-class.php#__CDATAL
libsensorPy.concretesensor.tcs34725.TCS34725.__CDATAH	libsensorPy.concretesensor.tcs34725.TCS34725-class.php#__CDATAH
libsensorPy.concretesensor.tcs34725.TCS34725.__PERS_30_CYCLE	libsensorPy.concretesensor.tcs34725.TCS34725-class.php#__PERS_30_CYCLE
libsensorPy.concretesensor.tcs34725.TCS34725.__RDATAL	libsensorPy.concretesensor.tcs34725.TCS34725-class.php#__RDATAL
libsensorPy.concretesensor.tcs34725.TCS34725.__write8	libsensorPy.concretesensor.tcs34725.TCS34725-class.php#__write8
libsensorPy.concretesensor.tcs34725.TCS34725.__RDATAH	libsensorPy.concretesensor.tcs34725.TCS34725-class.php#__RDATAH
libsensorPy.concretesensor.tcs34725.TCS34725.__setGain	libsensorPy.concretesensor.tcs34725.TCS34725-class.php#__setGain
libsensorPy.concretesensor.tcs34725.TCS34725.calculateColorTemperature	libsensorPy.concretesensor.tcs34725.TCS34725-class.php#calculateColorTemperature
libsensorPy.concretesensor.tcs34725.TCS34725.__enable	libsensorPy.concretesensor.tcs34725.TCS34725-class.php#__enable
libsensorPy.concretesensor.tcs34725.TCS34725.__getGain	libsensorPy.concretesensor.tcs34725.TCS34725-class.php#__getGain
libsensorPy.concretesensor.tcs34725.TCS34725.__PERS_15_CYCLE	libsensorPy.concretesensor.tcs34725.TCS34725-class.php#__PERS_15_CYCLE
libsensorPy.abstractclass.lightSensor.LightSensor.getColorTemperature	libsensorPy.abstractclass.lightSensor.LightSensor-class.php#getColorTemperature
libsensorPy.concretesensor.tcs34725.TCS34725.__readU8	libsensorPy.concretesensor.tcs34725.TCS34725-class.php#__readU8
libsensorPy.concretesensor.tcs34725.TCS34725.clearInterrupt	libsensorPy.concretesensor.tcs34725.TCS34725-class.php#clearInterrupt
libsensorPy.concretesensor.tcs34725.TCS34725.__setIntegrationTime	libsensorPy.concretesensor.tcs34725.TCS34725-class.php#__setIntegrationTime
libsensorPy.concretesensor.tcs34725.TCS34725.__AILTH	libsensorPy.concretesensor.tcs34725.TCS34725-class.php#__AILTH
libsensorPy.concretesensor.tcs34725.TCS34725.__AILTL	libsensorPy.concretesensor.tcs34725.TCS34725-class.php#__AILTL
libsensorPy.abstractclass.lightSensor.LightSensor.getColorTemperatureInKelvin	libsensorPy.abstractclass.lightSensor.LightSensor-class.php#getColorTemperatureInKelvin
libsensorPy.concretesensor.tcs34725.TCS34725.__readU16Rev	libsensorPy.concretesensor.tcs34725.TCS34725-class.php#__readU16Rev
libsensorPy.concretesensor.tcs34725.TCS34725.__GAIN_1X	libsensorPy.concretesensor.tcs34725.TCS34725-class.php#__GAIN_1X
libsensorPy.concretesensor.tcs34725.TCS34725.setup	libsensorPy.concretesensor.tcs34725.TCS34725-class.php#setup
libsensorPy.concretesensor.tcs34725.TCS34725.__INTEGRATIONTIME_50MS	libsensorPy.concretesensor.tcs34725.TCS34725-class.php#__INTEGRATIONTIME_50MS
libsensorPy.concretesensor.tcs34725.TCS34725.__ENABLE_WEN	libsensorPy.concretesensor.tcs34725.TCS34725-class.php#__ENABLE_WEN
libsensorPy.concretesensor.tcs34725.TCS34725.__WTIME_204MS	libsensorPy.concretesensor.tcs34725.TCS34725-class.php#__WTIME_204MS
libsensorPy.concretesensor.tcs34725.TCS34725.__STATUS_AINT	libsensorPy.concretesensor.tcs34725.TCS34725-class.php#__STATUS_AINT
libsensorPy.concretesensor.tcs34725.TCS34725.__PERS_60_CYCLE	libsensorPy.concretesensor.tcs34725.TCS34725-class.php#__PERS_60_CYCLE
libsensorPy.concretesensor.tcs34725.TCS34725.__COMMAND_BIT	libsensorPy.concretesensor.tcs34725.TCS34725-class.php#__COMMAND_BIT
libsensorPy.concretesensor.tcs34725.TCS34725.__PERS_45_CYCLE	libsensorPy.concretesensor.tcs34725.TCS34725-class.php#__PERS_45_CYCLE
libsensorPy.concretesensor.tcs34725.TCS34725.__PERS_10_CYCLE	libsensorPy.concretesensor.tcs34725.TCS34725-class.php#__PERS_10_CYCLE
libsensorPy.concretesensor.tcs34725.TCS34725.__WTIME_614MS	libsensorPy.concretesensor.tcs34725.TCS34725-class.php#__WTIME_614MS
libsensorPy.concretesensor.tcs34725.TCS34725.__CONFIG	libsensorPy.concretesensor.tcs34725.TCS34725-class.php#__CONFIG
libsensorPy.concretesensor.tcs34725.TCS34725.__integrationTimeDelay	libsensorPy.concretesensor.tcs34725.TCS34725-class.php#__integrationTimeDelay
libsensorPy.concretesensor.tcs34725.TCS34725.__del__	libsensorPy.concretesensor.tcs34725.TCS34725-class.php#__del__
libsensorPy.concretesensor.tcs34725.TCS34725.__init__	libsensorPy.concretesensor.tcs34725.TCS34725-class.php#__init__
libsensorPy.concretesensor.tcs34725.TCS34725.__INTEGRATIONTIME_24MS	libsensorPy.concretesensor.tcs34725.TCS34725-class.php#__INTEGRATIONTIME_24MS
libsensorPy.concretesensor.tcs34725.TCS34725.setIntLimits	libsensorPy.concretesensor.tcs34725.TCS34725-class.php#setIntLimits
libsensorPy.concretesensor.tcs34725.TCS34725.__getRawData	libsensorPy.concretesensor.tcs34725.TCS34725-class.php#__getRawData
libsensorPy.concretesensor.tcs34725.TCS34725.__ENABLE_AIEN	libsensorPy.concretesensor.tcs34725.TCS34725-class.php#__ENABLE_AIEN
libsensorPy.concretesensor.tcs34725.TCS34725.__PERS_55_CYCLE	libsensorPy.concretesensor.tcs34725.TCS34725-class.php#__PERS_55_CYCLE
libsensorPy.concretesensor.tcs34725.TCS34725.disable	libsensorPy.concretesensor.tcs34725.TCS34725-class.php#disable
libsensorPy.concretesensor.tcs34725.TCS34725.changeSetup	libsensorPy.concretesensor.tcs34725.TCS34725-class.php#changeSetup
libsensorPy.concretesensor.tcs34725.TCS34725.__BDATAH	libsensorPy.concretesensor.tcs34725.TCS34725-class.php#__BDATAH
libsensorPy.concretesensor.urm37.URM37	libsensorPy.concretesensor.urm37.URM37-class.php
libsensorPy.abstractclass.ultrasonicSensor.UltrasonicSensor.__metaclass__	libsensorPy.abstractclass.ultrasonicSensor.UltrasonicSensor-class.php#__metaclass__
libsensorPy.concretesensor.urm37.URM37.distance_in_cm	libsensorPy.concretesensor.urm37.URM37-class.php#distance_in_cm
libsensorPy.abstractclass.sensor.Sensor.__del__	libsensorPy.abstractclass.sensor.Sensor-class.php#__del__
libsensorPy.concretesensor.urm37.URM37.changeSetup	libsensorPy.concretesensor.urm37.URM37-class.php#changeSetup
libsensorPy.concretesensor.urm37.URM37.setup	libsensorPy.concretesensor.urm37.URM37-class.php#setup
libsensorPy.abstractclass.ultrasonicSensor.UltrasonicSensor.distance_in_inches	libsensorPy.abstractclass.ultrasonicSensor.UltrasonicSensor-class.php#distance_in_inches
libsensorPy.abstractclass.ultrasonicSensor.UltrasonicSensor._bin2dec	libsensorPy.abstractclass.ultrasonicSensor.UltrasonicSensor-class.php#_bin2dec
libsensorPy.concretesensor.urm37.URM37.__init__	libsensorPy.concretesensor.urm37.URM37-class.php#__init__
libsensorPy.extension.extendedUltrasonicSensorFactory.ExtendedUltrasonicSensorFactory	libsensorPy.extension.extendedUltrasonicSensorFactory.ExtendedUltrasonicSensorFactory-class.php
libsensorPy.abstractclass.abstractSensorFactory.AbstractSensorFactory.__metaclass__	abc.ABCMeta-class.php
libsensorPy.abstractclass.abstractSensorFactory.AbstractSensorFactory._abc_negative_cache	libsensorPy.abstractclass.abstractSensorFactory.AbstractSensorFactory-class.php#_abc_negative_cache
libsensorPy.extension.extendedUltrasonicSensorFactory.ExtendedUltrasonicSensorFactory.createSensor	libsensorPy.extension.extendedUltrasonicSensorFactory.ExtendedUltrasonicSensorFactory-class.php#createSensor
libsensorPy.extension.extendedUltrasonicSensorFactory.ExtendedUltrasonicSensorFactory.__init__	libsensorPy.extension.extendedUltrasonicSensorFactory.ExtendedUltrasonicSensorFactory-class.php#__init__
libsensorPy.abstractclass.abstractSensorFactory.AbstractSensorFactory._abc_cache	libsensorPy.abstractclass.abstractSensorFactory.AbstractSensorFactory-class.php#_abc_cache
libsensorPy.abstractclass.abstractSensorFactory.AbstractSensorFactory.__abstractmethods__	libsensorPy.abstractclass.abstractSensorFactory.AbstractSensorFactory-class.php#__abstractmethods__
libsensorPy.abstractclass.abstractSensorFactory.AbstractSensorFactory._abc_negative_cache_version	libsensorPy.abstractclass.abstractSensorFactory.AbstractSensorFactory-class.php#_abc_negative_cache_version
libsensorPy.abstractclass.abstractSensorFactory.AbstractSensorFactory._abc_registry	libsensorPy.abstractclass.abstractSensorFactory.AbstractSensorFactory-class.php#_abc_registry
libsensorPy.concretefactory.ultrasonicSensorFactory.UltrasonicSensorFactory.createEvent	libsensorPy.concretefactory.ultrasonicSensorFactory.UltrasonicSensorFactory-class.php#createEvent
libsensorPy.extension.hcsr04.HCSR04	libsensorPy.extension.hcsr04.HCSR04-class.php
libsensorPy.abstractclass.ultrasonicSensor.UltrasonicSensor.__metaclass__	libsensorPy.abstractclass.ultrasonicSensor.UltrasonicSensor-class.php#__metaclass__
libsensorPy.extension.hcsr04.HCSR04.distance_in_cm	libsensorPy.extension.hcsr04.HCSR04-class.php#distance_in_cm
libsensorPy.abstractclass.sensor.Sensor.__del__	libsensorPy.abstractclass.sensor.Sensor-class.php#__del__
libsensorPy.extension.hcsr04.HCSR04.changeSetup	libsensorPy.extension.hcsr04.HCSR04-class.php#changeSetup
libsensorPy.extension.hcsr04.HCSR04.setup	libsensorPy.extension.hcsr04.HCSR04-class.php#setup
libsensorPy.abstractclass.ultrasonicSensor.UltrasonicSensor.distance_in_inches	libsensorPy.abstractclass.ultrasonicSensor.UltrasonicSensor-class.php#distance_in_inches
libsensorPy.abstractclass.ultrasonicSensor.UltrasonicSensor._bin2dec	libsensorPy.abstractclass.ultrasonicSensor.UltrasonicSensor-class.php#_bin2dec
libsensorPy.extension.hcsr04.HCSR04.__init__	libsensorPy.extension.hcsr04.HCSR04-class.php#__init__
libsensorPy.utils.pycomms.PyComms	libsensorPy.utils.pycomms.PyComms-class.php
libsensorPy.utils.pycomms.PyComms.write8	libsensorPy.utils.pycomms.PyComms-class.php#write8
libsensorPy.utils.pycomms.PyComms.readBit	libsensorPy.utils.pycomms.PyComms-class.php#readBit
libsensorPy.utils.pycomms.PyComms.readS16	libsensorPy.utils.pycomms.PyComms-class.php#readS16
libsensorPy.utils.pycomms.PyComms.writeBit	libsensorPy.utils.pycomms.PyComms-class.php#writeBit
libsensorPy.utils.pycomms.PyComms.reverseByteOrder	libsensorPy.utils.pycomms.PyComms-class.php#reverseByteOrder
libsensorPy.utils.pycomms.PyComms.readBytesListS	libsensorPy.utils.pycomms.PyComms-class.php#readBytesListS
libsensorPy.utils.pycomms.PyComms.readU8	libsensorPy.utils.pycomms.PyComms-class.php#readU8
libsensorPy.utils.pycomms.PyComms.writeBits	libsensorPy.utils.pycomms.PyComms-class.php#writeBits
libsensorPy.utils.pycomms.PyComms.writeList	libsensorPy.utils.pycomms.PyComms-class.php#writeList
libsensorPy.utils.pycomms.PyComms.readBytesListU	libsensorPy.utils.pycomms.PyComms-class.php#readBytesListU
libsensorPy.utils.pycomms.PyComms.readBits	libsensorPy.utils.pycomms.PyComms-class.php#readBits
libsensorPy.utils.pycomms.PyComms.readU16	libsensorPy.utils.pycomms.PyComms-class.php#readU16
libsensorPy.utils.pycomms.PyComms.readBytes	libsensorPy.utils.pycomms.PyComms-class.php#readBytes
libsensorPy.utils.pycomms.PyComms.readS8	libsensorPy.utils.pycomms.PyComms-class.php#readS8
libsensorPy.utils.pycomms.PyComms.__init__	libsensorPy.utils.pycomms.PyComms-class.php#__init__
